# Thx
# https://wikiwiki.jp/nenaiko/
# https://a-to-monhan.com/2020/12/28/rise-kannji-yomikata/

# 武器2(ハンマー,ランス,ガンランス,スラッシュアックス)

##########
# ハンマー
あいあんはんまー	アイアンハンマー	名詞
あいしくるばっしゅ	アイシクルバッシュ	名詞
あいすしぇいかー	アイスシェイカー	名詞
あかしまのしんつい	あかしまの神槌	名詞
あかしま	あかしま	名詞
しんつい	神槌	名詞
あくえりあんぼむ	アクエリアンボム	名詞
あくせるはんまー	アクセルハンマー	名詞
あるまぐろーぶ	アルマグローブ	名詞
いかりはんまー	イカリハンマー	名詞
うぃるがしぇるぷれす	ウィルガシェルプレス	名詞
うずまくほねのかいつい	渦巻く骨の塊鎚	名詞
かいつい	塊鎚	名詞
うちゅうせいふくすーぱーえいと	宇宙征服！スーパーエイト	名詞
えあしっぷはんまー	エアシップハンマー	名詞
えいきゅうひょうかい	永久氷塊	名詞
えっぐはんまー	エッグハンマー	名詞
えむろーどびーと	エムロードビート	名詞
えんおうつい	炎王鎚	名詞
えんおうつい	炎王鎚【灼岩】	名詞
しゃくがん	灼岩	名詞
えんかくつい	炎角鎚	名詞
えんかくつい	炎角鎚【炎陽】	名詞
えんよう	炎陽	名詞
おうがつい	王牙鎚	名詞
おうがつい	王牙鎚【大雷】	名詞
だいらい	大雷	名詞
おうこくきしおおつちぱわー	王国騎士大鎚パワー	名詞
おにのかお	鬼ノ貌	名詞
おにのくろがね	鬼鉄	名詞
おやすみべあ	おやすみベア	名詞
おるどまきな	オルドマキナ	名詞
おるどまきな	オルドマキナ・H	名詞
がいあすぷ	ガイアスプ	名詞
がいらはんまー	ガイラハンマー	名詞
かおすらっしゅ	カオスラッシュ	名詞
かくおうついかおすおーだー	角王鎚カオスオーダー	名詞
かくおうつい	角王鎚	名詞
かおすおーだー	カオスオーダー	名詞
がのへっど	ガノヘッド	名詞
かむらのてっこうつい	カムラノ鉄鉤鎚	名詞
からみてぃーさいん	カラミティーサイン	名詞
かりゅうさいふらかん	火竜砕フラカン	名詞
かりゅうさい	火竜砕	名詞
ふらかん	フラカン	名詞
かりゅうもうついあなとり	火竜猛鎚アナトリ	名詞
かりゅうもうつい	火竜猛鎚	名詞
あなとり	アナトリ	名詞
かんなりのしんつい	かんなりの神槌	名詞
しんつい	神槌	名詞
ぎざみへっどあくす	ギザミヘッドアクス	名詞
きょうがくのにくきゅうはんまー	驚愕の肉球ハンマー	名詞
きょうきょう	凶鏡	名詞
きょうきょう	凶鏡【妖雲】	名詞
よううん	妖雲	名詞
きょじゅうつい	巨獣鎚	名詞
きょりゅうつい	巨龍鎚	名詞
きょりゅうつい	巨龍鎚【蓬莱】	名詞
ほうらい	蓬莱	名詞
きんかいのですもてりおん	禁戒のデスモテリオン	名詞
きんかい	禁戒	名詞
ですもてりおん	デスモテリオン	名詞
きんねこはんまー	きんねこハンマー	名詞
ぎんよくのせんつい	銀翼の穿鎚	名詞
ぎんよく	銀翼	名詞
せんつい	穿鎚	名詞
くっくじょー	クックジョー	名詞
くらすたーはんまー	クラスターハンマー	名詞
くれいじーでぃー	クレイジー・D	名詞
ぐれいとふるはむ	グレイトフルハム	名詞
ぐれーとのゔぁ	グレートノヴァ	名詞
ぐれんくらいす	グレンクライス	名詞
くろなべ	黒鍋	名詞
くろなべ	黒鍋【好吃】	名詞
はおちー	好吃	名詞
げききんじしいんぱくと	激!金獅子インパクト	名詞
げきついおんすろーと	激鎚オンスロート	名詞
げきつい	激鎚	名詞
おんすろーと	オンスロート	名詞
げんらいつい	幻雷鎚	名詞
げんらいつい	幻雷鎚【雷電】	名詞
らいでん	雷電	名詞
こうこくけんついあるめた	煌黒堅鎚アルメタ	名詞
こうこくけんつい	煌黒堅鎚	名詞
あるめた	アルメタ	名詞
ごうつい	轟槌	名詞
ごうつい	轟槌【虎丸】	名詞
とらまる	虎丸	名詞
こうついごぐま	甲鎚ゴグマ	名詞
こうぼうきんせいおおなぐり	工房謹製・オオナグリ	名詞
おおなぐり	オオナグリ	名詞
こうぼうしさくひんがんはんま	工房試作品ガンハンマ	名詞
がんはんま	ガンハンマ	名詞
こうぼうしさくひんげきりゅうつい	工房試作品撃龍鎚	名詞
げきりゅうつい	撃龍鎚	名詞
こーれだぐど	コーレダグド	名詞
こーんへっどはんまー	コーンヘッドハンマー	名詞
こきゅーとす	コキュートス	名詞
こくりゅうつい	刻竜鎚	名詞
こついつきをいざない	狐鎚ツキヲイザナイ	名詞
こつい	狐鎚	名詞
つきをいざない	ツキヲイザナイ	名詞
ごるむがべる	ゴルム・ガベル	名詞
ころさるだおら	コロサル＝ダオラ	名詞
ごしゃべちゃ	ゴシャベチャ	名詞
ごわごわのおんねん	ゴワゴワの怨念	名詞
こんがりにく	こんがり肉	名詞
こんがりにく	こんがり肉【特選】	名詞
さぼてんはんまー	さぼてんハンマー	名詞
さんだーわーくす	サンダーワークス	名詞
しぎんつい	司銀鎚	名詞
しぎんつい	司銀鎚【孤月】	名詞
こげつ	孤月	名詞
しそのほのおをだきしはな	始祖ノ炎ヲ抱キシ花	名詞
しゃくえんのいしゃたー	灼炎のイシャター	名詞
しゃくえん	灼炎	名詞
いしゃたー	イシャター	名詞
しんひもうつい	真緋猛槌	名詞
しんひもうつい	真緋猛槌【弥久】	名詞
やひさ	弥久	名詞
しんぶらいつい	真舞雷鎚	名詞
しんぶらいつい	真舞雷鎚【八咫烏】	名詞
やたがらす	八咫烏	名詞
すい	スイ	名詞
すいついゔぉじゃのーい	水鎚ヴォジャノーイ	名詞
すいつい	水鎚	名詞
ゔぉじゃのーい	ヴォジャノーイ	名詞
すてぐま	ステグマ	名詞
すてぐま	ステグマ【壱之型】	名詞
いちのかた	壱之型	名詞
すぱいくはんまー	スパイクハンマー	名詞
せきりゅうのつかむつち	赤龍ノ掴ム鎚	名詞
ぜーげじゃう	ゼーゲジャウ	名詞
ぜのまふぁがるな	ゼノ＝マファガルナ	名詞
まふぁがるな	マファガルナ	名詞
だいこつかい	大骨塊	名詞
だいだらぼらす	ダイダラボラス	名詞
つめたきつきのさいつい	冷たき月の砕鎚	名詞
さいつい	砕鎚	名詞
ておくらりあ	テオ＝クラリア	名詞
くらりあ	クラリア	名詞
ですぐらしあ	デスグラシア	名詞
てっけん	テッケン	名詞
てんぐごこのつち	天具・五鈷の槌	名詞
ごこ	五鈷	名詞
ごこのつち	五鈷の槌	名詞
どくつい	毒槌	名詞
どくつい	毒槌【鳥兜】	名詞
とりかぶと	鳥兜	名詞
どどんですとろい	ドドン・デストロイ	名詞
どはつだいつい	怒髪大鎚	名詞
どはつだいつい	怒髪大鎚【巨浪】	名詞
きょろう	巨浪	名詞
どはつごうだいらーじゃん	怒髪豪ダイラージャン	名詞
だいらーじゃん	ダイラージャン	名詞
どもりっしょんはむ	ドモリッション・ハム	名詞
どもりっしょん	ドモリッション	名詞
とらぐめーね	トラグ・メーネ	名詞
どらぐろはんまー	ドラグロハンマー	名詞
どらごんですとろい	ドラゴンデストロイ	名詞
なぁむばど	ナァムバド	名詞
ななとり	ナナ＝トリ	名詞
にげるかりぷす	ニゲル＝カリプス	名詞
かりぷす	カリプス	名詞
ねぶららぴす	ネブララピス	名詞
ねるがるくらっしゅ	ネルガルクラッシュ	名詞
はーんはんまー	ハーンハンマー	名詞
ばいんどきゅーぶ	バインドキューブ	名詞
はがんついのゔぁじお	破岩鎚ノヴァジオ	名詞
はがんつい	破岩鎚	名詞
のゔぁじお	ノヴァジオ	名詞
ばさるばっしゅ	バサルバッシュ	名詞
はついしゃったー	破鎚シャッター	名詞
はっしん、げきりゅうついいさな	発進、撃龍鎚イサナ!	名詞
ぱるせいとこあ	パルセイト・コア	名詞
ぱるせいと	パルセイト	名詞
ぱわーおぶぐれあ	パワーofグレア	名詞
ぱんくへっずすらむ	パンクヘッズスラム	名詞
ひどぅんぶれいかー	ヒドゥンブレイカー	名詞
ひゃくりゅうつい	百竜鎚	名詞
ふぁってぃぷっしゅ	ファッティプッシュ	名詞
ふがくつい	浮岳槌	名詞
ふがくつい	浮岳槌【天空城】	名詞
#てんくうじょう	天空城	名詞
ふくろだたき	フクロダタキ	名詞
ぶらすなっくる	ブラスナックル	名詞
ふらむえるすふぃり	フラムエルスフィリ	名詞
ふりんとぺっこ	フリントペッコ	名詞
ぶるたすくはんまー	ブルタスクハンマー	名詞
ぶれすこあ	ブレス・コア	名詞
ふろぎぃいろーど	フロギィイロード	名詞
こうそうのつち	紅爪ノ鎚	名詞
こうそうのつち	紅爪ノ鎚【破】	名詞
べねふろる	ベネ・フロル	名詞
べるだーはんまー	ベルダーハンマー	名詞
ほうざんついもーらん	峯山鎚モーラン	名詞
ほうざんつい	峯山鎚	名詞
もーらん	モーラン	名詞
ほうついおてるかむるばす	崩槌オテルカムルバス	名詞
ほうつい	崩槌	名詞
おてるかむるばす	オテルカムルバス	名詞
ほうついのきんぞくき	宝鎚の金属器	名詞
ほうつい	宝鎚	名詞
きんぞくき	金属器	名詞
ほうびんといふなのしろむくろ	宝瓶といふ名の白骸	名詞
ほうびん	宝瓶	名詞
ぽりたん	ポリタン	名詞
ぼるてっくはんまー	ボルテックハンマー	名詞
ぽるとまるく	ポルトマルク	名詞
ぼんじゃろ	ボン・ジャロ	名詞
まがつつつち	禍ツ槌	名詞
まがつつつち	禍ツ槌【封】	名詞
まぐだふろが	マグダ・フロガ	名詞
まぐにちゅーど	マグニチュード	名詞
まじんついえくすぱんど	魔神鎚エクスパンド	名詞
まじんつい	魔神鎚	名詞
ついえくすぱんど	エクスパンド	名詞
まとらかあるぐる	マトラカアルグル	名詞
めいしゅざいしょうこうま	明珠在掌―降魔―	名詞
めいしゅざいしょう	明珠在掌―降魔―	名詞
めいしゅざいしょう	明珠在掌	名詞
こうま	降魔	名詞
みらあんせするいん	ミラアンセスルイン	名詞
みらがるずいーら	ミラガルズイーラ	名詞
みらばすたー	ミラバスター	名詞
みんちょうきゅうきょくつい	眠鳥究極槌	名詞
みんちょうきゅうきょくつい	眠鳥究極槌【永眠】	名詞
えいみん	永眠	名詞
めいえんきょついあねもす	冥淵巨鎚アネモス	名詞
めいえんきょつい	冥淵巨鎚	名詞
きょついあねもす	アネモス	名詞
めろうぶろう	メロウブロウ	名詞
やまごんげん	山権現	名詞
ゆぴてるぐろーぶ	ユピテルグローブ	名詞
りゅうとうがいこん	龍頭蓋棍	名詞
れいついかぼちゃおう	霊槌カボチャ王	名詞
ろーぜんはんまー	ローゼンハンマー	名詞
ろぶすたんぷ	ロブスタンプ	名詞
ろりぽっぷ	ロリポップ	名詞
でぃーすぃ	D=スィ	名詞
あにばけーき	アニバケーキ	名詞
あにばけーき	10thアニバケーキ	名詞
よんにーしきはこうつい	42式破甲鎚	名詞
ごうつい	豪槌	名詞
ごうつい	豪槌【櫛名田】	名詞
くしなだ	櫛名田	名詞
ふがくつい	富嶽対	名詞
ごうはつい	豪破槌	名詞
ごうはつい	豪破槌【倭撫子】	名詞
やまとなでしこ	倭撫子	名詞

##########
# ランス
あいあんらんす	アイアンランス	名詞
あいしくるぶりざーど	アイシクルブリザード	名詞
あいすらんさー	アイスランサー	名詞
あかしまのしんそう	あかしまの神槍	名詞
あかしま	あかしま	名詞
しんそう	神槍	名詞
あくえりあす	アクエリアス	名詞
あずーるくれすと	アズールクレスト	名詞
あつめしごうかくのやり	集めし剛殻の槍	名詞
あとろしすたわー	アトロシスタワー	名詞
あらくらんつぇ	アラクランツェ	名詞
あるごあんゔぃる	アルゴアンヴィル	名詞
あんぐりーほーん	アングリーホーン	名詞
あんどれいやー	アンドレイヤー	名詞
ゔぁるはら	ヴァルハラ	名詞
ゔーろーとぶろす	ヴーロートブロス	名詞
ゔぇのむらんす	ヴェノムランス	名詞
うずまくぐれんのむじゅん	渦巻ク紅蓮ノ矛楯	名詞
えむろーどている	エムロードテイル	名詞
えめらるどすぴあ	エメラルドスピア	名詞
えんぷれすらんす	エンプレスランス	名詞
えんかくそう	炎角槍	名詞
えんかくそう	炎角槍【刺座】	名詞
しざ	刺座	名詞
えんごくりゅうのやり	焔嶽龍ノ槍	名詞
えんごくりゅう	焔嶽龍	名詞
えんひそう	炎妃槍	名詞
えんひそう	炎妃槍【華麗】	名詞
おうがそう	王牙槍	名詞
おうがそう	王牙槍【若雷】	名詞
じゃくらい	若雷	名詞
おうこくきしやりがーど	王国騎士槍ガード	名詞
おるどまきな	オルドマキナ・L	名詞
おるどまきなえる	オルドマキナ・L	名詞
おるどまきな	オルドマキナ	名詞
がーでぃあんらんす	ガーディアンランス	名詞
かいおうほうさきなばるえくす	海王鋒ナバルエクス	名詞
かいおうほう	海王鋒	名詞
さきなばるえくす	ナバルエクス	名詞
かいしょうかっちん	かいしょうかっちん	名詞
がいらくれすと	ガイラクレスト	名詞
かぜのぞくそう	風ノ賊槍	名詞
ぞくそう	賊槍	名詞
かっせんそう	合戦槍	名詞
かむらのてつそう	カムラノ鉄鎗	名詞
てつそう	鉄鎗	名詞
がろんらんす	ガロンランス	名詞
かんなりのしんそう	かんなりの神槍	名詞
ぎぃねすとらんす	ギィネストランス	名詞
きかいはくりゅうそう	輝界白竜槍	名詞
きかいはくりゅうそう	輝界白竜槍【光突】	名詞
こうとつ	光突	名詞
きそうらーじゃん	鬼槍ラージャン	名詞
ぎふとかいざー	ギフト＝カイザー	名詞
きょうむ	凶矛	名詞
きょうむ	凶矛【凌雲】	名詞
りょううん	凌雲	名詞
きょじゅうそう	巨獣槍	名詞
ぎんよくのせんそう	銀翼の尖槍	名詞
ぎんよく	銀翼	名詞
せんそう	尖槍	名詞
くしゃれたーる	クシャ＝レタール	名詞
くしゃ	クシャ	名詞
れたーる	レタール	名詞
くりむぞんほーん	クリムゾンホーン	名詞
くるるらんす	クルルランス	名詞
くろおびらんす	クロオビランス	名詞
くろすころりす	クロスコロリス	名詞
げきりゅうそう	撃竜槍	名詞
げきりゅうそう	撃竜槍【阿】	名詞
あ	阿	名詞
げんらいそう	幻雷槍	名詞
げんらいそう	幻雷槍【雷光】	名詞
らいこう	雷光	名詞
こうこくそうあるとらす	煌黒槍アルトラス	名詞
こうこくそう	煌黒槍	名詞
あるとらす	アルトラス	名詞
ごうそう	轟槍	名詞
ごうそう	轟槍【独虎】	名詞
どっこ	独虎	名詞
こうぼうしさくひんがんらんす	工房試作品ガンランス	名詞
ひょうこうせん	氷鮫銛	名詞
ひょうこうえいせん	氷鮫鋭銛	名詞
こーれえくさ	コーレエクサ	名詞
ごくらいそう	極雷槍	名詞
ごくらいそう	極雷槍【鎌髭】	名詞
かまひげ	鎌髭	名詞
こくめつりゅうそう	黒滅龍槍	名詞
こくりゅうそう	黒龍槍	名詞
ごしゃどしゅ	ゴシャドシュ	名詞
こそうはなもはななれ	狐槍ハナモハナナレ	名詞
こそう	狐槍	名詞
はなもはななれ	ハナモハナナレ	名詞
ざくぅんた	ザクゥンタ	名詞
しーるどおぶあーねすと	シールドofアーネスト	名詞
じぇびあぱるちざん	ジェビアパルチザン	名詞
しぎんそう	司銀槍	名詞
しぎんそう	司銀槍【鳥雲】	名詞
とりくも	鳥雲	名詞
しごくぶらいそう	至極舞雷槍	名詞
しごくぶらいそう	至極舞雷槍【緊那羅】	名詞
きんなら	緊那羅	名詞
しばれたうんめいおこすやり	凍レタ運命熾ス槍	名詞
しばれたうんめいをおこすやり	凍レタ運命熾ス槍	名詞
しゃーくきんぐ	シャークキング	名詞
しゃくえんのすゔぁろー	灼炎のスヴァロー	名詞
しゃくえん	灼炎	名詞
すゔぁろー	スヴァロー	名詞
しゃくじょうそう	錫杖槍	名詞
しゃくじょうそう	錫杖槍【天照】	名詞
あまてらす	天照	名詞
じゃそう	蛇槍	名詞
じゃそう	蛇槍【ナーガ】	名詞
なーが	ナーガ	名詞
じゃそうるーんねぶら	邪槍ルーンネブラ	名詞
じゃそう	邪槍	名詞
るーんねぶら	ルーンネブラ	名詞
じゅうかそうぐらびもす	重火槍グラビモス	名詞
じゅうかそう	重火槍	名詞
ぐらびもす	グラビモス	名詞
しるむずらんしあ	シルムズランシア	名詞
しんめいらいそう	真冥雷槍	名詞
しんめいらいそう	真冥雷槍【鴆】	名詞
じん	鴆	名詞
すぱいくすぴあ	スパイクスピア	名詞
すぱいらるひーと	スパイラルヒート	名詞
すぱいらるらんす	スパイラルランス	名詞
すぴんくろうらー	スピンクロウラー	名詞
せいしきさいようかいてんきかいそう	正式採用回転機械槍	名詞
せいばーとぅーす	セイバートゥース	名詞
せきりゅうのつらぬくつの	赤龍ノ貫ク角	名詞
ぜーげろんぐほーん	ゼーゲロングホーン	名詞
そりゅうれいそう	祖龍霊槍	名詞
だーくねす	ダークネス	名詞
だいやもんどだすと	ダイヤモンドダスト	名詞
だんきそう	団旗槍	名詞
だんきそう	団旗槍【順風】	名詞
だんはたそう	団旗槍	名詞
だんはたそう	団旗槍【流星】	名詞
ちゃくむるか	チャク・ムルカ	名詞
ちゃく	チャク	名詞
むるか	ムルカ	名詞
ちゃちゃぶーらんす	チャチャブーランス	名詞
ちょうめつげきそうでぃあぶろす	長滅激槍ディアブロス	名詞
ちょうめつげきそう	長滅激槍	名詞
つきさし	ツキサシ	名詞
つきだし	突キダシ	名詞
てぃふぉんだおら	ティフォン＝ダオラ	名詞
てぃふぉん	ティフォン	名詞
だおら	ダオラ	名詞
でゅーくいんぺいる	デュークインペイル	名詞
ておはうる	テオ＝ハウル	名詞
てお	テオ	名詞
はうる	ハウル	名詞
てりおすだおら	テリオス＝ダオラ	名詞
てりおす	テリオス	名詞
だおら	ダオラ	名詞
どぅーむくらうん	ドゥームクラウン	名詞
どがんごくそう	弩岩獄槍	名詞
どがんごくそう	弩岩獄槍【闇雲突】	名詞
やみくもにつけ	闇雲突	名詞
どどんまうんてん	ドドン・マウンテン	名詞
どどん	ドドン	名詞
どはつせんそう	怒髪閃槍	名詞
どはつせんそう	怒髪閃槍【皐月】	名詞
とらいでんと	トライデント	名詞
なーるふぉらーず	ナールフォラーズ	名詞
にくきゅうらんす	肉球ランス	名詞
にげるうるてぃお	ニゲル＝ウルティオ	名詞
にげる	ニゲル	名詞
うるてぃお	ウルティオ	名詞
ねいてぃぶすぴあ	ネイティブスピア	名詞
ねぶらこるむな	ネブラコルムナ	名詞
ねるがるかるが	ネルガルカルガ	名詞
ばーしにゃきおーん	バーシニャキオーン	名詞
ばーばりあんたすく	バーバリアンタスク	名詞
はがんそうぶらきでぃおす	破岩槍ブラキディオス	名詞
はがんそう	破岩槍	名詞
ぶらきでぃおす	ブラキディオス	名詞
ばきゅーむすてぃっく	バキュームスティック	名詞
ばくろうそう	爆狼槍	名詞
ばくろうそう	爆狼槍【ウガチ】	名詞
うがち	ウガチ	名詞
ばしりすゔぉんたーで	バシリスヴォンターデ	名詞
ばべる	バベル	名詞
ぱらえみてぃーふぇ	パラエミティーフェ	名詞
ぱらっしゅにーどる	パラッシュニードル	名詞
はるばあるめんかる	ハルバアルメンカル	名詞
ひどぅんすてぃんがー	ヒドゥンスティンガー	名詞
ひもうそう	緋猛槍	名詞
ひもうそう	緋猛槍【仙道】	名詞
せんどう	仙道	名詞
ひゃくりゅう鎗	百竜鎗	名詞
ひゅどろすうーら	ヒュドロスウーラ	名詞
ひかみなりやりつきかがち	飛雷槍ツキカガチ	名詞
かぜ旋のぶりんぷ	風旋のブリンプ	名詞
かぜ旋	風旋	名詞
ぶりんぷ	ブリンプ	名詞
ふうりゅうそう	封龍槍	名詞
ふうりゅうそう	封龍槍【刹那】	名詞
ふぇろーている	フェローテイル	名詞
ふぉんでゅらんす	フォンデュランス	名詞
ふがくそう	浮岳槍	名詞
ふがくそう	浮岳槍【極楽浄土】	名詞
ぷっちばばらんす	プッチババランス	名詞
ふるふるらんす	フルフルランス	名詞
ぶれいんふぉっくす	ブレインフォックス	名詞
ふれぐらんす	フレグランス	名詞
ぶろすほーん	ブロスホーン	名詞
べるだーらんす	ベルダーランス	名詞
ほうそうけるけかむるばす	崩槍ケルケカムルバス	名詞
ほうそう	崩槍	名詞
けるけかむるばす	ケルケカムルバス	名詞
ほうそうのきんぞくき	宝槍の金属器	名詞
ほうそうそう	宝槍	名詞
きんぞくき	金属器	名詞
ほうてんげき	ホウテンゲキ	名詞
ぼーんくろうらんす	ボーンクロウランス	名詞
ぼーんらんす	ボーンランス	名詞
まかつといふなのしろむくろ	磨羯といふ名の白骸	名詞
まかつ	磨羯	名詞
まがつそう	禍ツ槍	名詞
まがつそう	禍ツ槍【封】	名詞
まてんろう	マテンロウ	名詞
めいせんとつそうぱごす	冥淵突槍パゴス	名詞
めいせんとつそう	冥淵突槍	名詞
ぱごす	パゴス	名詞
もうそうどすふぁんご	猛槍ドスファンゴ	名詞
もうそう	猛槍	名詞
どすふぁんご	ドスファンゴ	名詞
やまづきはるむべるく	山衝ハルムベルク	名詞
やまづき	山衝	名詞
はるむべるく	ハルムベルク	名詞
らーゔぁこーん	ラーヴァコーン	名詞
らいきそう	雷鬼槍	名詞
らいきそう	雷鬼槍【壊】	名詞
らいそう	雷槍	名詞
らいそう	雷槍【イカズチ】	名詞
いかずち	イカズチ	名詞
らいそうどーりす	雷槍ドーリス	名詞
どーりす	ドーリス	名詞
らぎっどらんす	ラギッドランス	名詞
らんぐすとろーく	ラングストローク	名詞
らもーるのあいしゅう	ラ・モールの哀愁	名詞
らもーる	ラ・モール	名詞
りのはすたー	リノハスター	名詞
りゅうきそうげいぼるぐ	竜騎槍ゲイボルグ	名詞
りゅうきそう	竜騎槍	名詞
げいぼるぐ	ゲイボルグ	名詞
るかーにあそー	ルカーニアソー	名詞
れいじんぐてんぺすと	レイジングテンペスト	名詞
れぎーなそーん	レギーナソーン	名詞
れくいえむすぴあ	レクイエムスピア	名詞
れつせんそういりやふぃーす	烈閃槍イリヤフィース	名詞
れつせんそう	烈閃槍	名詞
いりやふぃーす	イリヤフィース	名詞
れっどている	レッドテイル	名詞
れっどるーん	レッドルーン	名詞
ろーぜんらんつぇ	ローゼンランツェ	名詞
ろんぐほーん	ロングホーン	名詞
よんじゅうさんしききょうしゅうそう	43式強襲槍	名詞

##########
# ガンランス
がんらんす	ガンランス	名詞
あーむおぶてぃらん	アームofティラン	名詞
てぃらん	ティラン	名詞
あーりゃがっだ	アーリャガッダ	名詞
あいあんがんらんす	アイアンガンランス	名詞
あいすりったー	アイスリッター	名詞
あいぜんりったー	アイゼンリッター	名詞
あいりゅーしか	アイリューシカ	名詞
あかしまのしんじゅうそう	あかしまの神銃槍	名詞
あかしま	あかしま	名詞
しんじゅうそう	神銃槍	名詞
あすふぁあるだなぶ	アスファアルダナブ	名詞
いてつくときをおこすじゅうそう	凍テツク時ヲ熾獣槍	名詞
じゅうそう	獣槍	名詞
うるくすれい	ウルクスレイ	名詞
ゔぁしむじぇむぅ	ヴァシム・ジェムゥ	名詞
ゔぁしむ	ヴァシム	名詞
じぇむぅ	ジェムゥ	名詞
ゔぇんとかみーの	ヴェントカミーノ	名詞
えむろーどるーく	エムロードルーク	名詞
えりゅーけいす	エリュー・ケイス	名詞
えりゅー	エリュー	名詞
けいす	ケイス	名詞
えんおうりゅうのせきじゅうそう	炎王龍の石銃槍	名詞
えんおうりゅう	炎王龍	名詞
せきじゅうそう	石銃槍	名詞
えんぷれすはうる	エンプレスハウル	名詞
えんまめつりゅうじゅうそう	焔魔滅龍銃槍	名詞
おうがじゅうそう	王牙銃槍	名詞
おうがじゅうそう	王牙銃槍【火雷】	名詞
ひかみなり	火雷	名詞
ひがみなり	火雷	名詞
おうこくきしじゅうそうぷれっじ	王国騎士銃槍プレッジ	名詞
ぷれっじ	プレッジ	名詞
おべりすく	オベリスク	名詞
おるどまきなGL	オルドマキナ・GL	名詞
おるどまきな	オルドマキナ	名詞
じーえる	GL	名詞
かいおうそうりゔぁいあさん	海王槍リヴァイアサン	名詞
かいおうそう	海王槍	名詞
かいじゅうそうがるくっく	怪銃槍ガルクック	名詞
かいじゅうそう	怪銃槍	名詞
がるくっく	ガルクック	名詞
かいぞくじぇーがんらんす	海賊Jガンランス	名詞
かいぞくじぇー	海賊J	名詞
がいらばすたー	ガイラバスター	名詞
かどまつじゅうそう	門松銃槍	名詞
かどまつじゅうそう	門松銃槍【深雪】	名詞
みゆき	深雪	名詞
がのりぃん	ガノリィン	名詞
かまくらんす	かまくランス	名詞
かむらのてつじゅうそう	カムラノ鉄銃そう	名詞
かりゅうじゅうそう	火竜銃槍	名詞
がりゅうじゅうそう	牙竜銃槍	名詞
かりゅうもうじゅうそうやふたれく	火竜猛銃槍ヤフタレク	名詞
がるきゃのん	ガルキャノン	名詞
かれいなるとしゅけのん	華麗なるトシュケノン	名詞
としゅけのん	トシュケノン	名詞
がんしょうがいじゅうそうだいもんど	岩漿鎧銃槍ダイモンド	名詞
がんしょうがいじゅう	岩漿鎧銃槍	名詞
だいもんど	ダイモンド	名詞
がんちゃりおっと	ガンチャリオット	名詞
かんなりのしんじゅうそう	かんなりの神銃槍	名詞
かんなり	かんなり	名詞
しんじゅうそう	神銃槍	名詞
きょうじゅうそう	凶銃槍	名詞
きょうじゅうそう	凶銃槍【瑞雨】	名詞
ずいう	瑞雨	名詞
きょじゅうじゅうそう	巨獣銃槍	名詞
ぎんよくのじゅうそう	銀翼の銃槍	名詞
ぎんよく	銀翼	名詞
じゅうそう	銃槍	名詞
くぉんでがんらんす	クォンデガンランス	名詞
げんしょうじゅうそうるふれい	眩晶銃槍ルフレイ	名詞
げんしょう	眩晶	名詞
げんしょうじゅう	眩晶銃槍	名詞
そうるふれい	ルフレイ	名詞
げんらいじゅうそう	幻雷銃槍	名詞
げんらいじゅうそう	幻雷銃槍【豪雷】	名詞
ごうらい	豪雷	名詞
こうこくじゅうそうあるめると	煌黒銃槍アルメルト	名詞
こうこく	煌黒銃槍	名詞
こうこくじゅうそう	煌黒銃槍	名詞
そうあるめると	アルメルト	名詞
ごうじゅうそう	轟銃槍	名詞
ごうじゅうそう	轟銃槍【虎砲】	名詞
こほう	虎砲	名詞
ごくあんこくじゃりゅうりゅうじゅうそう	極・闇黒邪龍銃槍	名詞
あんこくじゃりゅうりゅうじゅうそう	闇黒邪龍銃槍	名詞
こくじゅうそう	黒銃槍	名詞
こくりゅうじゅうそう	刻竜銃槍	名詞
こだいしきせんめつじゅうそう	古代式殲滅銃槍	名詞
こつじゅうそう	骨銃槍	名詞
ことうそううきよのやみを	狐灯槍ウキヨノヤミヲ	名詞
ことうそう	狐灯槍	名詞
うきよのやみを	ウキヨノヤミヲ	名詞
こりゅうじゅうそうえんぶれむ	古龍銃槍エンブレム	名詞
こりゅうじゅう	古龍銃槍	名詞
ごるむべねっと	ゴルム・ベネット	名詞
ごるむ	ゴルム	名詞
べねっと	ベネット	名詞
さいがほう	砕牙砲	名詞
さかまくまくきょうせいのじゅうそう	逆まく凶星の銃槍	名詞
さんさんけんげん	燦々顕現	名詞
さんせんとう	サンセントウ	名詞
さんせんとう	サンセントウ【禍】	名詞
わざわい	禍	名詞
しーだいばー	シーダイバー	名詞
じぇねらるぱるど	ジェネラルパルド	名詞
しぇるがんばーど	シェルガンバード	名詞
しかつじゅうそう	紫蠍銃槍	名詞
しかつじゅうそう	紫蠍銃槍【完全結晶】	名詞
しかつ	紫蠍	名詞
かんぜんけっしょう	完全結晶	名詞
しざーがんらんす	シザーガンランス	名詞
しつらいのじゅうそう	疾雷ノ銃槍	名詞
しつらい	疾雷	名詞
じゃぎぃがんらんす	ジャギィガンランス	名詞
しゃくえんのかべいらー	灼炎のカベイラー	名詞
かべいらー	カベイラー	名詞
じゅうそうらららんす	銃槍ララランス	名詞
らららんす	ララランス	名詞
しゅきじゅうそう	朱鬼銃槍	名詞
しゅき	朱鬼	名詞
あかおに	朱鬼	名詞
しょっとがんらんす	ショットガンランス	名詞
しるむずがりんぐ	シルムズガリング	名詞
しれつなるしゅらにおつやり	熾烈ナル修羅ニ墜ツそう	名詞
じんばといふなのしろむくろ	人馬といふ名の白骸	名詞
すかーじらんしす	スカージ・ランシス	名詞
すかーじ	スカージ	名詞
らんしす	ランシス	名詞
すかーれっとくぃーん	スカーレットクィーン	名詞
すとーむがんらんす	ストームガンランス	名詞
すのうぎあ	スノウギア	名詞
せきりゅうのやぶるそう	赤龍ノ破ル槍	名詞
ぜのへむた	ゼノ＝ヘムタ	名詞
ぜの	ゼノ	名詞
へむた	ヘムタ	名詞
ぜんちょうのぷろふぇてぃあ	前兆のプロフェティア	名詞
ぷろふぇてぃあ	プロフェティア	名詞
そりゅうれいじゅうそう	祖龍霊銃槍	名詞
だーどすらすと	ダードスラスト	名詞
たいほうもろこし	大砲モロコシ	名詞
だおらぶりじあ	ダオラ＝ブリジア	名詞
だおら	ダオラ	名詞
ぶりじあ	ブリジア	名詞
だんでぃずむ	ダンディズム	名詞
ちぇーんがんらんす	チェーンガンランス	名詞
ちくじゅうそう	竹銃槍	名詞
つめたきつきのじゅうそう	冷たき月の銃槍	名詞
でぃあぶるじーと	ディアブルジート	名詞
ておぶらすと	テオ＝ブラスト	名詞
ぶらすと	ブラスト	名詞
てぽすといぐらー	テポストイグラー	名詞
でゅあるとぅーす	デュアルトゥース	名詞
でゅーくばよねっと	デュークバヨネット	名詞
でるくはーぷなー	デルクハープナー	名詞
でんじゅうそうふるぼると	電銃槍フルボルト	名詞
でんじゅうそう	電銃槍	名詞
ふるぼると	フルボルト	名詞
てんろうじゅうそう	天狼銃槍	名詞
てんろうじゅうそう	天狼銃槍【極光】	名詞
きょっこう	極光	名詞
とうがらしじゅうそう	唐辛子銃槍	名詞
どどんげいざー	ドドン・ゲイザー	名詞
どどん	ドドン	名詞
げいざー	ゲイザー	名詞
とらいがんらんす	トライガンランス	名詞
どらぐゔぁいす	ドラグヴァイス	名詞
どろすはーぷーん	ドロスハープーン	名詞
ななはうる	ナナ＝ハウル	名詞
なな	ナナ	名詞
はうる	ハウル	名詞
にくやきじゅうそう	ニクヤキ銃槍	名詞
にげるあだむ	ニゲル＝アダム	名詞
にげる	ニゲル	名詞
あだむ	アダム	名詞
ねぶらふらんま	ネブラフランマ	名詞
ねむりをさそうかいじゅうそう	睡りを誘う貝銃槍	名詞
かいじゅうそう	貝銃槍	名詞
ねるがるくらんぶる	ネルガルクランブル	名詞
ねろえふぃーら	ネロ・エフィーラ	名詞
ねろ	ネロ	名詞
えふぃーら	エフィーラ	名詞
ねろぐりーど	ネロ＝グリード	名詞
ねろ	ネロ	名詞
ぐりーど	グリード	名詞
はーどぼーんきゃのん	ハードボーンキャノン	名詞
はがんじゅうそうずゔぉるた	破岩銃槍ズヴォルタ	名詞
はがんじゅうそう	破岩銃槍	名詞
ずゔぉるた	ズヴォルタ	名詞
ばぎぃがんらんす	バギィガンランス	名詞
はざくすぴさ	ハザクスピサ	名詞
はじゅうそうあぺかむとるむ	覇銃槍アペカムトルム	名詞
はじゅうそう	覇銃槍	名詞
あぺかむとるむ	アペカムトルム	名詞
はじゅうそうぬいかむとるむ	覇銃槍ヌイカムトルム	名詞
はじゅうそう	覇銃槍	名詞
ぬいかむとるむ	ヌイカムトルム	名詞
ばずーかがんらんす	バズーカガンランス	名詞
ばぜるばすたー	バゼルバスター	名詞
はちしききかいそう	八式機械槍	名詞
ぱるさーがんらんす	パルサーガンランス	名詞
ばれなれいど	バレナレイド	名詞
ひーろーがんらんす	ヒーローガンランス	名詞
びっぐすらっがー	ビッグスラッガー	名詞
ひどぅんがんらんす	ヒドゥンガンランス	名詞
ひもうじゅうそう	緋猛銃槍	名詞
ひもうじゅうそう	緋猛銃槍【武勇】	名詞
ぶゆう	武勇	名詞
ひゃくりゅうじゅうそう	百竜銃そう	名詞
ひゅぷのきゃのん	ヒュプノキャノン	名詞
ひるばーがんらんす	ヒルバーガンランス	名詞
ふぃおれせろ	フィオレセロ	名詞
ふぇざーとりっきー	フェザートリッキー	名詞
ふぉるてぱっつぃーあ	フォルテパッツィーア	名詞
ふらむえるはすた	フラムエルハスタ	名詞
ぶらすぶると	ブラスブルト	名詞
ぷらちなくらうん	プラチナクラウン	名詞
ぶらふまーすとら	ブラフマーストラ	名詞
ぷりんせすばーすと	プリンセスバースト	名詞
ふれあぶろす	フレアブロス	名詞
ぶれいくらんあうと	ブレイクランアウト	名詞
ふれいむすろわー	フレイムスロワー	名詞
ぺっこてぃぴー	ペッコティピー	名詞
べなむでぱるふぁん	ベナムデパルファン	名詞
べるだーがんらんす	ベルダーガンランス	名詞
へるぶりざーど	ヘルブリザード	名詞
ほうじゅうそうぱしかむるばす	崩銃槍パシカムルバス	名詞
ほうじゅうそう	崩銃槍	名詞
ぱしかむるばす	パシカムルバス	名詞
ほうじょうのはぜるきんぞくき	宝杖の爆ぜる金属器	名詞
ほうじょう	宝杖	名詞
ぼるてぃっくわーくす	ボルティックワークス	名詞
ほろらばるすと	ホロラバルスト	名詞
ほわいとがんらんす	ホワイトガンランス	名詞
まがつほうそう	禍ツ砲槍	名詞
まがつほうそう	禍ツ砲槍【封】	名詞
ふう	封	名詞
まぐだらはと	マグダ・ラハト	名詞
まぐだ	マグダ	名詞
らはと	ラハト	名詞
みすたごあーど	ミスタゴアード	名詞
めいえんじゅうそうくらてぃす	冥淵銃槍クラティス	名詞
めいえんじゅう	冥淵銃槍	名詞
くらてぃす	クラティス	名詞
もあだーくきゃのん	モアダークキャノン	名詞
らいきじゅうそうどらがん	雷鬼銃槍ドラガン	名詞
らいき	雷鬼銃槍	名詞
そうどらがん	ドラガン	名詞
らいじゅうそうえくすらぎあ	雷銃槍エクスラギア	名詞
らいじゅうそう	雷銃槍	名詞
えくすらぎあ	エクスラギア	名詞
らゔぁがんらんす	ラヴァガンランス	名詞
らずるすらっがー	ラズルスラッガー	名詞
りゅうぼくのやり	龍木ノ槍	名詞
りゅうぼく	龍木	名詞
りゅうれきいんせいしきじゅうそう	龍歴院正式銃槍	名詞
れっどるーく	レッドルーク	名詞
ろうがじゅうそう	狼牙銃槍	名詞
ろうがじゅうそう	狼牙銃槍【貪獄】	名詞
ひんごく	貪獄	名詞
ろーぐがんらんす	ローグガンランス	名詞
ろーぜんかのーね	ローゼンカノーネ	名詞
ろすかぐれもす	ロスカグレモス	名詞
でぃーねい	D=ネイ	名詞
ぶいくれすと	V-クレスト	名詞
ろくにーしきとつげきじゅうそう	62式突撃銃槍	名詞

##########
# スラッシュアックス
すらっしゅあっくす	スラッシュアックス	名詞
けんぶ	剣斧	名詞
あいあんあっくす	アイアンアックス	名詞
あいするーど	アイスルード	名詞
あかしまのしんけんぶ	あかしまの神剣斧	名詞
あかしま	あかしま	名詞
しんけんぶ	神剣斧	名詞
あくさあるだばらん	アクサアルダバラン	名詞
あさるとあっくす	アサルトアックス	名詞
あっしゅどらっへ	アッシュドラッヘ	名詞
あるきみあ	アルキミア	名詞
あるとえれがん	アルトエレガン	名詞
あんこくとしゃくねつのけんとおの	暗黒ト赤熱ノ剣ト斧	名詞
あんばーすらっしゅ	アンバースラッシュ	名詞
ゔぁーゔんあっくす	ヴァーヴンアックス	名詞
ゔぇのむべいる	ヴェノムベイル	名詞
ゔぉるかてなく	ヴォルカ・テナク	名詞
ゔぉるか	ヴォルカ	名詞
てなく	テナク	名詞
うぃるおぶしぇいぷ	ウィルofシェイプ	名詞
えいりんをつらねしおの	鋭鱗を連ねし斧	名詞
えいりん	鋭鱗	名詞
えんかくごくけんぶ	炎角獄剣斧	名詞
えんかくごくけんぶ	炎角獄剣斧【炎咲】	名詞
えんさき	炎咲	名詞
えんごくりゅうのけんぶ	焔嶽龍ノ剣斧	名詞
えんぶおぶれいあーど	焔斧リオブレイアード	名詞
えんぶ	焔斧	名詞
りおぶれいあーど	リオブレイアード	名詞
えんぷれすあくす	エンプレスアクス	名詞
おうがけんぶ	王牙剣斧	名詞
おうがけんぶ	王牙剣斧【裂雷】	名詞
れつらい	裂雷	名詞
おうこくきしけんぶろいやる	王国騎士剣斧ロイヤル	名詞
おうこくきしけんぶ	王国騎士剣斧	名詞
ろいやる	ロイヤル	名詞
おるどまきな	オルドマキナ	名詞
おるどまきな	オルドマキナ・SA	名詞
えすえー	SA	名詞
かいぞくじぇーあっくす	海賊Jアックス	名詞
かいぞくじぇー	海賊J	名詞
がいらあっくす	ガイラアックス	名詞
がうすれっじ	ガウスレッジ	名詞
がけつけんぶばんぴあ	喰血剣斧バンピア	名詞
がけつけんぶ	喰血剣斧	名詞
ばんぴあ	バンピア	名詞
かむらのてつけんぶ	カムラノ鉄剣斧	名詞
がらかれいど	ガラカレイド	名詞
がんしょうがいけんぶこすも	岩漿鎧剣斧コスモ	名詞
がんしょうがいけんぶ	岩漿鎧剣斧	名詞
こすも	コスモ	名詞
かんなりのしんけんぶ	かんなりの神剣斧	名詞
かんなり	かんなり	名詞
しんけんぶ	神剣斧	名詞
きょうけんぶ	凶剣斧	名詞
きょうけんぶ	凶剣斧【白雨】	名詞
はくう	白雨	名詞
きょじゅうけんぶ	巨獣剣斧	名詞
ぎんよくのけんぶ	銀翼の剣斧	名詞
ぎんよく	銀翼	名詞
くりだーるあーら	クリダール＝アーラ	名詞
くりだーる	クリダール	名詞
あーら	アーラ	名詞
ぐりむきゃっと	グリムキャット	名詞
ぐれーとなばるたすく	グレートナバルタスク	名詞
くろおびあっくす	クロオビアックス	名詞
けんぶのおりがた	剣斧ノ折形	名詞
けんぶのおりがた	剣斧ノ折形【桜雲】	名詞
ろううん	桜雲	名詞
ごあげいるあずらいと	ゴアゲイルアズライト	名詞
こうじんだーかーそにっく	甲刃ダーカーソニック	名詞
こうじん	甲刃	名詞
だーかーそにっく	ダーカーソニック	名詞
ごーだあっくす	ゴーダアックス	名詞
こうひょうぶきりん	降雹斧キリン	名詞
こうひょうぶ	降雹斧	名詞
こーれてねぶらい	コーレテネブライ	名詞
こくとけんぶ	黒兎剣斧	名詞
こくめつりゅうけんぶ	黒滅龍剣斧	名詞
こくりゅうけんぶ	黒龍剣斧	名詞
こけんぶわかれをさそふ	狐剣斧ワカレヲサソフ	名詞
こけんぶ	狐剣斧	名詞
わかれをさそふ	ワカレヲサソフ	名詞
ごるばばんだーる	ゴルババンダール	名詞
ごるむあくす	ゴルム・アクス	名詞
ごるむ	ゴルム	名詞
あくす	アクス	名詞
こんごうかくぶ	金剛角斧	名詞
じぇびあばおしん	ジェビアバオシン	名詞
じえろてゅれいら	ジエロ・テュレイラ	名詞
じえろ	ジエロ	名詞
てゅれいら	テュレイラ	名詞
しごくぶらいぶ	至極舞雷斧	名詞
しごくぶらいぶ	至極舞雷斧【姑獲鳥】	名詞
しゅうかくちょう	姑獲鳥	名詞
しざーあくす	シザーアクス	名詞
しゃくえんのどらふぁー	灼炎のドラファー	名詞
しゃくえん	灼炎	名詞
どらふぁー	ドラファー	名詞
しゃくえん	灼炎	名詞
どらふぁー	ドラファー	名詞
じゃぐらすあっくす	ジャグラスアックス	名詞
じゃしゅうのこんきすた	邪執のコンキスタ	名詞
じゃしゅう	邪執	名詞
こんきすた	コンキスタ	名詞
しるむずふぁーね	シルムズファーネ	名詞
すてあらいず=わんど	ステアライズ＝ワンド	名詞
すてあらいず	ステアライズ	名詞
すらっしゅふぉっくす	スラッシュフォックス	名詞
せいえいとうばつたいけんぶ	精鋭討伐隊剣斧	名詞
せいゆうぶ	青熊斧	名詞
せきりゅうのうつけんぶ	赤龍ノ討ツ剣斧	名詞
ぜっていせいけんぶ	絶帝征剣斧	名詞
ぜっていせいけんぶ	絶帝征剣斧【聖王】	名詞
せいおう	聖王	名詞
たいらんとあっくす	タイラントアックス	名詞
だちゅらがーでん	ダチュラガーデン	名詞
だんらいぶきりん	断雷斧キリン	名詞
だんらいぶ	断雷斧	名詞
ちゃちゃぶあいるー	チャチャブアイルー	名詞
つめたきつきのけんぶ	冷たき月の剣斧	名詞
でぃーえっじ	ディーエッジ	名詞
ておきゃっする	テオ＝キャッスル	名詞
ですぴあだど	デスピアダド	名詞
てつせいしさくけんぶ	鉄製試作剣斧	名詞
でゅーくあくすと	デュークアクスト	名詞
てゅらんのす	テュランノス	名詞
でるくせーげる	デルクセーゲル	名詞
てんかつといふなのしろむくろ	天蝎といふ名の白骸	名詞
てんぐほうりんのおの	天具・法輪の斧	名詞
てんぐ	天具	名詞
ほうりん	法輪	名詞
どらごんりっぱー	ドラゴンリッパー	名詞
どろすあっくす	ドロスアックス	名詞
ねむりをさそうかいけんぶ	睡りを誘う貝剣斧	名詞
ねるがるがっしゅ	ネルガルガッシュ	名詞
ねろすとろびら	ネロ・ストロビラ	名詞
ねろ	ネロ	名詞
すとろびら	ストロビラ	名詞
のっちすだいる	ノッチスダイル	名詞
ばうんどろーらー	バウンドローラー	名詞
はがんけんぶえくりくしー	破岩剣斧エクリクシー	名詞
はがんけんぶ	破岩剣斧	名詞
えくりくしー	エクリクシー	名詞
はくとけんぶ	白兎剣斧	名詞
はけんぶむるかむとるむ	覇剣斧ムルカムトルム	名詞
はけんぶ	覇剣斧	名詞
むるかむとるむ	ムルカムトルム	名詞
はざくでみおす	ハザクデミオス	名詞
ばぜるれいだー	バゼルレイダー	名詞
ぱるざだおら	パルザ＝ダオラ	名詞
ぱるざ	パルザ	名詞
だおら	ダオラ	名詞
ばんこつおおなた	蛮骨大鉈	名詞
ばんざいくろえ	万歳クロエ	名詞
ばんざい	万歳	名詞
くろえ	クロエ	名詞
ばんゆうのけんぶ	蛮勇の剣斧	名詞
ばんゆうのけんぶ	蛮勇の剣斧【無頼】	名詞
ぶらい	無頼	名詞
びーくあっくす	ビークアックス	名詞
ひどぅんあっくす	ヒドゥンアックス	名詞
ひゃくりゅうけんぶ	百竜剣斧	名詞
ふぁいあてんぺすと	ファイアテンペスト	名詞
ふぃんすらっしゅ	フィンスラッシュ	名詞
ふーでぃー	フー=D	名詞
ふとけんぶ	布都剣斧	名詞
ぶらっくはーべすと	ブラックハーベスト	名詞
ふらむえるしすか	フラムエルシスカ	名詞
ふらんしすか	フランシスカ	名詞
ふりっくあっくす	フリックアックス	名詞
ふるふるつーる	フルフルツール	名詞
ぺきすぱんだー	ペキスパンダー	名詞
へびぃでぃばいど	ヘビィディバイド	名詞
べるだーあっくす	ベルダーアックス	名詞
ほうけんぶむるかむるばす	崩剣斧ムルカムルバス	名詞
ほうけんぶ	崩剣斧	名詞
むるかむるばす	ムルカムルバス	名詞
ほうぶのへんげんするきんぞくき	宝斧の変幻する金属器	名詞
ほうぶ	宝斧	名詞
へんげんするきんぞくき	変幻する金属器	名詞
ぼーんあっくす	ボーンアックス	名詞
ぼるしゅれっど	ボルシュレッド	名詞
ぼるとあっくす	ボルトアックス	名詞
まがつおの	禍ツ斧	名詞
まがつおの	禍ツ斧【封】	名詞
ふう	封	名詞
まさかり	魔鎖狩	名詞
みちとのかいこう	未知との邂逅	名詞
みらあんせすふぉーす	ミラアンセスフォース	名詞
めいえんけんぶきまろえー	冥淵剣斧キマロエー	名詞
めいえんけんぶ	冥淵剣斧	名詞
きまろえー	キマロエー	名詞
もーたーばーすと	モーターバースト	名詞
ゆきぞくのけんぶ	雪族の剣斧	名詞
ゆきぞく	雪族	名詞
らいとねるぐれいぶ	ライトネルグレイブ	名詞
りーむすあっしゅ	リームスアッシュ	名詞
りゅうきのけんぶ	竜姫の剣斧	名詞
りゅうき	竜姫	名詞
りゅうれきいんせいしきけんぶ	龍歴院正式剣斧	名詞
れっくすらっしゅ	レックスラッシュ	名詞
れっどとまほーく	レッドトマホーク	名詞
ろうがけんぶ	狼牙剣斧	名詞
ろうがけんぶ	狼牙剣斧【暴獄】	名詞
ぼうごく	暴獄	名詞
ろーぜんあかんた	ローゼンアカンタ	名詞
わいるどあっくす	ワイルドアックス	名詞

##########
# チャージアックス
ちゃーじあっくす	チャージアックス	名詞
じゅんふ	神盾斧	名詞
あいすがーでぃあん	アイスガーディアン	名詞
あかしまのしんじゅんふ	あかしまの神盾斧	名詞
あかしま	あかしま	名詞
しんじゅんふ	神盾斧	名詞
あすらとあるまいさ	アスラトアルマイサ	名詞
あらくねすけいる	アラクネスケイル	名詞
あるかなどろー	アルカナドロー	名詞
いんふぇくすべいる	インフェクスベイル	名詞
ゔぁいくべいる	ヴァイクベイル	名詞
ゔぁいすりったー	ヴァイスリッター	名詞
えんふあくせりおん	炎斧アクセリオン	名詞
えんふ	炎斧	名詞
あくせりおん	アクセリオン	名詞
えんぷれすあるま	エンプレスアルマ	名詞
おうこくきしじゅんふえすぷり	王国騎士盾斧エスプリ	名詞
おうこくきしじゅんふ	王国騎士盾斧	名詞
えすぷり	エスプリ	名詞
おうがじゅんふ	王牙盾斧	名詞
おうがじゅんふ	王牙盾斧【風雷】	名詞
ふうらい	風雷	名詞
おうけんそうじゅん	桜剣蒼盾	名詞
おうけんそうじゅん	桜剣蒼盾【燕】	名詞
つばめ	燕	名詞
おるどまきな	オルドマキナ・CB	名詞
おるどまきな	オルドマキナ	名詞
しーびー	CB	名詞
がいらあーむず	ガイラアームズ	名詞
かすみりゅうのせきふ	霞龍の石斧	名詞
かすみりゅう	霞龍	名詞
せきふ	石斧	名詞
かぜのぞくじゅんふ	風ノ賊盾斧	名詞
ごうしょうひねり	合ショウヒネリ	名詞
かどるきゃっと	カドルキャット	名詞
かむらのてつじゅんふ	カムラノ鉄盾斧	名詞
がろんあーむず	ガロンアームズ	名詞
かんなりのしんじゅんふ	かんなりの神盾斧	名詞
かんなり	かんなり	名詞
しんじゅんふ	神盾斧	名詞
ぎがんとあーむず	ギガントアームズ	名詞
きじんじゅんふ	鬼神盾斧	名詞
きじんじゅんふ	鬼神盾斧【夜叉】	名詞
やしゃ	夜叉	名詞
きょうか	凶華	名詞
きょうか	凶華【朧雲】	名詞
おぼろぐも	朧雲	名詞
きょうじんをまといしせんぐ	凶刃を纏いし戦具	名詞
きょじゅうじゅんふ	巨獣盾斧	名詞
ぎるおすあーむず	ギルオスアームズ	名詞
ぎんよくのじゅんふ	銀翼の盾斧	名詞
ぎんよく	銀翼	名詞
じゅんふ	盾斧	名詞
げいげいといふなのしろむくろ	鯨鯢といふ名の白骸	名詞
げいげい	鯨鯢	名詞
しろむくろ	白骸	名詞
きつねころもおのみずにやどれる	狐衣斧ミズニヤドレル	名詞
きつねころもおの	狐衣斧	名詞
みずにやどれる	ミズニヤドレル	名詞
ごうりょくふめつ	業力不滅―閻王―	名詞
ごうりょくふめつえんおう	業力不滅―閻王―	名詞
えんおう	閻王	名詞
こくめつりゅうじゅんふ	黒滅龍盾斧	名詞
こくりゅうじゅんふ	黒龍盾斧	名詞
ごしゃがしゃ	ゴシャガシャ	名詞
こつじゅんふ	骨盾斧	名詞
ごるむはーと	ゴルム・ハート	名詞
ごるむ	ゴルム	名詞
はーと	ハート	名詞
しーるどすくあーろ	シールドスクアーロ	名詞
しぞーわーが	シゾー・ワーガ	名詞
しぞー	シゾー	名詞
わーが	ワーガ	名詞
しゃくえんのでぃまんだー	灼炎のディマンダー	名詞
しゃくえん	灼炎	名詞
でぃまんだー	ディマンダー	名詞
じゃぐらすあーむず	ジャグラスアームズ	名詞
しゅんげんなるぽるとあっし	峻厳なるポルトアッシ	名詞
ぽるとあっし	ポルトアッシ	名詞
しるといんせくと	シルトインセクト	名詞
しんめつじゅんふあるぷると	神滅盾斧アル・プルト	名詞
しんめつじゅんふ	神滅盾斧	名詞
あるぷると	アル・プルト	名詞
すたーるーくあくす	スタールークアクス	名詞
すのーべいる	スノーベイル	名詞
せいえいとうばつたいじゅんふ	精鋭討伐隊盾斧	名詞
せきりゅうのまもるるじゅんふ	赤龍ノ護ル盾斧	名詞
ぜのらーつ	ゼノ＝ラーツ	名詞
ぜの	ゼノ	名詞
らーつ	ラーツ	名詞
だーくいーぐる	ダークイーグル	名詞
だいしょうのねいでぃあ	代償のネイディア	名詞
ねいでぃあ	ネイディア	名詞
だおらかすか	ダオラ＝カスカ	名詞
だおら	ダオラ	名詞
かすか	カスカ	名詞
ちゃーじふぉっくす	チャージフォックス	名詞
ちょうさだんしさくじゅんふ	調査団試作盾斧	名詞
つめたきつきのじゅんふ	冷たき月の盾斧	名詞
でぃあるてみす	ディア＝ルテミス	名詞
でぃあ	ディア	名詞
るてみす	ルテミス	名詞
でぃーぷしゅねーげる	ディープシュネーゲル	名詞
でぃーぷしゅらむ	ディープシュラム	名詞
ておのーゔぁ	テオ＝ノーヴァ	名詞
てお	テオ	名詞
のーゔぁ	ノーヴァ	名詞
でざーとうぉーる	デザートウォール	名詞
ですとねーたー	デストネーター	名詞
でゅーくしると	デュークシルト	名詞
でんふあくせらくれす	電斧アクセラクレス	名詞
でんふ	電斧	名詞
あくせらくれす	アクセラクレス	名詞
てんぷすぎあ	テンプス・ギア	名詞
てんぷす	テンプス	名詞
でんせつじぇーあんかー	伝説Jアンカー	名詞
でんせつじぇー	伝説J	名詞
あんかー	アンカー	名詞
なでぎり	ナデギリ	名詞
ねるがるすいんぐ	ネルガルスイング	名詞
のぶれすおぶりーじゅ	ノブレスオブリージュ	名詞
はがんじゅんふいふるぜんと	破岩盾斧イフルゼント	名詞
はがんじゅんふ	破岩盾斧	名詞
いふるぜんと	イフルゼント	名詞
はざくあすぴだ	ハザクアスピダ	名詞
はじゅんふえんかむとるむ	覇盾斧エンカムトルム	名詞
はじゅんふ	覇盾斧	名詞
えんかむとるむ	エンカムトルム	名詞
ぱるさーあーむず	パルサーアームズ	名詞
ひーろーあーむず	ヒーローアームズ	名詞
ぴざっくす	ピザックス	名詞
ひどぅんがーでぃあん	ヒドゥンガーディアン	名詞
ひゃくりゅうじゅんふ	百竜盾斧	名詞
ひゅどろすかるでぃあ	ヒュドロスカルディア	名詞
ひろいっくざんなばる	ヒロイックザンナバル	名詞
ふうりゅうじゅんふ	封龍盾斧	名詞
ふうりゅうじゅんふ	封龍盾斧【界分】	名詞
かいぶん	界分	名詞
ふぉーすおぶふぉーる	フォースofフォール	名詞
ぶらっくふるがーど	ブラックフルガード	名詞
ぶろすあーむず	ブロスアームズ	名詞
もちじゅんふもちつきね	餅盾斧モチツキネ	名詞
もちじゅんふ	餅盾斧	名詞
もちつきね	モチツキネ	名詞
べるだーあーむず	ベルダーアームズ	名詞
ぽいじんぐてぃあ	ポイジングティア	名詞
ほうそうのごういつなるきんぞくき	宝装の合一なる金属器	名詞
ほうそう	宝装	名詞
ごういつなるきんぞくき	合一なる金属器	名詞
ぼるぼろむだんか	ボルボロムダンカ	名詞
ほろろぞふぁー	ホロロゾファー	名詞
まがつまさかり	禍ツ鉞	名詞
まがつまさかり	禍ツ鉞【封】	名詞
まぐだまぬす	マグダ・マヌス	名詞
まぐだ	マグダ	名詞
まぬす	マヌス	名詞
みかいへたっすじゅんふ	未解へ達す盾斧	名詞
みらあんせすぶろう	ミラアンセスブロウ	名詞
めいえんじゅんふろぐみー	冥淵盾斧ログミー	名詞
めいえんじゅんふ	冥淵盾斧	名詞
ろぐみー	ログミー	名詞
めろうべろう	メロウベロウ	名詞
やたじゅんふ	八咫盾斧	名詞
らゔぁべいる	ラヴァベイル	名詞
らうんどほいーらー	ラウンドホイーラー	名詞
らぎあすとろむ	ラギアストロム	名詞
りゅうこつじゅんふ	龍骨盾斧	名詞
れっくすでぃばいど	レックスディバイド	名詞
ろーぐあっくす	ローグアックス	名詞
ろーぜんりゅーぺー	ローゼンリューペー	名詞
さんいちしきひりゅうちんあつようじゅんふ	31式飛竜鎮圧用盾斧	名詞

