# Thx
# https://wikiwiki.jp/nenaiko/
# https://a-to-monhan.com/2020/12/28/rise-kannji-yomikata/

# 武器1(太刀,大剣,片手剣,双剣)

えすぴー	SP	名詞
すぺしゃる	SP	名詞

##########
# 太刀
たち	太刀	名詞
あいすらーみな	アイスラーミナ	名詞
あかしまのしんとう	あかしまの神刀	名詞
しんとう	神刀	名詞
あずらくぐらまさ	アズラクグラマサ	名詞
あとらんてぃか	アトランティカ	名詞
あめざりがたな	アメザリ刀	名詞
あまのむらくものつるぎ	天叢雲剣	名詞
いえろうらかーん	イエロウラカーン	名詞
いちとらがたな	一虎刀	名詞
いんとう	隠刀	名詞
いんとう	隠刀【終焉ノ唱】	名詞
しゅうえんのうた	終焉ノ唱	名詞
ういんどいーたー	ウインドイーター	名詞
うらのめとりあ	ウラノメトリア	名詞
うるゔぁまらーん	ウルヴァマラーン	名詞
うんようろうじょう	雲羊鹿杖	名詞
えーるだおら	エール＝ダオラ	名詞
えくでぃしす	エクディシス	名詞
えんおうとう	炎王刀	名詞
えんおうとう	炎王刀【大焦熱】	名詞
だいしょうねつ	大焦熱	名詞
えんざん	炎斬	名詞
えんしゃく	焔灼	名詞
えんひとう	艶妃刀	名詞
えんひとう	艶妃刀【清雅】	名詞
せいが	清雅	名詞
えんぷれすそーど	エンプレスソード	名詞
おゔぃりおん	オヴィリオン	名詞
おうがとう	王牙刀	名詞
おうがとう	王牙刀【伏雷】	名詞
ふくらい	伏雷	名詞
おうこくきしたちぶれいぶ	王国騎士太刀ブレイブ	名詞
おおなぎなた	大薙刀	名詞
おおなぎなた	大薙刀【巴】	名詞
ともえ	巴	名詞
おになぎなた	鬼薙刀	名詞
おるどまきな	オルドマキナ	名詞
おるどまきな	オルドマキナ・LS	名詞
おるどまきなえるえす	オルドマキナ・LS	名詞
がーでぃあんそーど	ガーディアンソード	名詞
かいぞくかりのたましい	海賊狩りの魂	名詞
かいぞくじぇーそーど	海賊Jソード	名詞
がいらそーど	ガイラソード	名詞
がうしかたな	ガウシ刀	名詞
からおうがたな	殻王刀	名詞
からおうがたな	殻王刀【硬】	名詞
こう	硬	名詞
がくば	顎刃	名詞
がすぎゃるど	ガスギャルド	名詞
かぜのぞくとう	風ノ賊刀	名詞
ぞくとう	賊刀	名詞
がのすかたるしす	ガノスカタルシス	名詞
がのすらっしゃー	ガノスラッシャー	名詞
かまいたち	鎌威太刀	名詞
かむらのてっとう	カムラノ鉄刀	名詞
てっとう	鉄刀	名詞
からみてぃぺいん	カラミティペイン	名詞
がるそぶら	ガルソブラ	名詞
かんなりのしんとう	かんなりの神刀	名詞
がんせきとう	巖石刀	名詞
がんせきとう	巖石刀【崩壊】	名詞
きえん	気炎	名詞
きえんのたち	気炎の太刀	名詞
てるかいはくりゅうがたな	輝界白竜刀	名詞
てるかいはくりゅうがたな	輝界白竜刀【光流】	名詞
こうりゅう	光流	名詞
ぎがんとまかえら	ギガントマカエラ	名詞
きょうかがたでんねつとう	強化型電熱刀	名詞
でんねつとう	電熱刀	名詞
きょうとう	凶刀	名詞
きょうとう	凶刀【催花雨】	名詞
さいかう	催花雨	名詞
きょじゅうとう	巨獣刀	名詞
きょりゅうとう	巨龍刀	名詞
きょりゅうとう	巨龍刀【霊鷲山】	名詞
れいじゅざん	巨龍刀【霊鷲山】	名詞
ぎんよくとう	銀翼刀	名詞
くらいぶらっど	クライブラッド	名詞
くらぶかったー	クラブカッター	名詞
ぐらんつれべる	グランツ・レベル	名詞
ぐんとう	軍刀	名詞
けいでんのたち	継伝の太刀	名詞
けいでんのたち【むめい】	継伝の太刀【無銘】	名詞
むめい	無銘	名詞
げんらいとう	幻雷刀	名詞
げんらいとう	幻雷刀【聳弧】	名詞
しょうこ	聳弧	名詞
こいるどねいる	コイルドネイル	名詞
こううんりゅうすい	行雲流水	名詞
こううんりゅうすい	行雲流水―和光―	名詞
ごうこうしゅんはれん	剛鋼瞬破鎌	名詞
ごうこうしゅんはれん	剛鋼瞬破鎌【極】	名詞
こうりゅうのたち	コウリュウノタチ	名詞
ごくこうまじゃりゅうとう	獄・紅魔邪龍刀	名詞
こうまじゃりゅうとう	紅魔邪龍刀	名詞
こくとう	黒刀	名詞
こくとう	骨刀	名詞
こくばくとう	骨縛刀	名詞
こくばくとう	骨縛刀【カゲヌイ】	名詞
ことうかかるくもなき	狐刀カカルクモナキ	名詞
ことう	古刀	名詞
ことう	狐刀	名詞
かかるくもなき	カカルクモナキ	名詞
ごるむかったー	ゴルム・カッター	名詞
さえんなぎ	砂猿薙	名詞
さえんなぎ	砂猿薙【ゴゴゴ】	名詞
ごごご	ゴゴゴ	名詞
さざなみ	サザナミ	名詞
ざんざいのえるがれいおん	斬罪のエルガレイオン	名詞
ざんざい	斬罪	名詞
えるがれいおん	エルガレイオン	名詞
ざんばとう	斬破刀	名詞
ざんろうとう	斬老刀	名詞
ざんろうとう	斬老刀【スサノオ】	名詞
しっこくそう	漆黒爪	名詞
しっこくそう	漆黒爪【終焉】	名詞
しみたーあるなじと	シミターアルナジト	名詞
しゃくえんのるーがー	灼炎のルーガー	名詞
しゃるとぅ	シャルトゥ	名詞
しるむずさーぶる	シルムズサーブル	名詞
しんぱんのつばさ	審判の翼	名詞
しんひりゅうとう【ときつぐ】	真・飛竜刀【時継】	名詞
ひりゅうとう	飛竜刀	名詞
ときつぐ	時継	名詞
すいざん	水斬	名詞
すいざん	水斬【最終段】	名詞
すたーらいとげーと	スターライトゲート	名詞
すてぃーらー	スティーラー	名詞
すてぃーるおぶふぁくと	スティールofファクト	名詞
せいきらいかとう	清輝雷華刀	名詞
せいくうとう	征空刀	名詞
せいくうとう	征空刀【真炎】	名詞
しんえん	真炎	名詞
せいばいとう	成敗刀	名詞
せいゆうちょうひつ	青熊長筆	名詞
せいゆうちょうひつ	青熊長筆【留跳】	名詞
るちょう	留跳	名詞
せきりゅうのひらめくやいば	赤龍ノ閃ク刃	名詞
ぜのさいふぁ	ゼノ＝サイファ	名詞
そうぎょといふなのしろむくろ	双魚といふ名の白骸	名詞
あおぼしのたち	蒼星ノ太刀	名詞
あおぼしのたち	蒼星ノ太刀【舞龍】	名詞
ぶりゅう	舞龍	名詞
だーといーたー	ダートイーター	名詞
だいとう	ダイトウ	名詞
だおられいど	ダオラ＝レイド	名詞
たちうおのたち	タチウオノタチ	名詞
たちおうぎ	太刀扇	名詞
たちおうぎ	太刀扇【ガバス】	名詞
だんがたち	断牙太刀	名詞
ちーずにゃいふ	チーズニャイフ	名詞
ちぇーんぶれいど	チェーンブレイド	名詞
ちょうそうとう	長蒼刀	名詞
ちょうそうとう	長蒼刀【鎌将軍】	名詞
かましょうぐん	鎌将軍	名詞
つめたきつきのはくじん	冷たき月の白刃	名詞
はくじん	白刃	名詞
でぃあぱぞん	ディアパゾン	名詞
ていおうとう	帝王刀	名詞
てぃがのたち	ティガノタチ	名詞
ですぺれいしょん	デスペレイション	名詞
てつさいが	鉄砕牙	名詞
てっとう	鉄刀	名詞
でゅーくしんくれあ	デュークシンクレア	名詞
てんおこしとうどにさきくやいば	天熾シ凍土ニ咲ク刃	名詞
てんこうなきつるぎ	天煌亡剣	名詞
てんこうなきつるぎ	天煌亡剣【裏かぐや】	名詞
てんじょうてんげむそうとう	天上天下無双刀	名詞
てんろうとう	天狼刀	名詞
てんろうとう	天狼刀【須佐之男】	名詞
すさのお	須佐之男	名詞
どらうんぽーる	ドラウンポール	名詞
どらぐろかすてっろ	ドラグロカステッロ	名詞
なんばんとう	南蛮刀	名詞
にげるれくす	ニゲル＝レクス	名詞
ねぶられくす	ネブラレクス	名詞
ねるがるりーゔぇ	ネルガルリーヴェ	名詞
ねろとるなりあ	ネロ・トルナリア	名詞
のこぎりひしゅ	鋸斬り匕首	名詞
ひしゅ	匕首	名詞
はおうけん	覇王剣	名詞
はがんとう	破岩刀	名詞
はがんとうほむら	破岩刀ホムラ	名詞
はくとじん	白兎刃	名詞
ばくりんのたち	爆鱗の大刀	名詞
ばすてぃんえっじ	バスティンエッジ	名詞
はていとうえむかむとるむ	覇帝刀エムカムトルム	名詞
はていとう	覇帝刀	名詞
えむかむとるむ	エムカムトルム	名詞
はとうたんねかむとるむ	覇刀タンネカムトルム	名詞
はとう	覇刀	名詞
たんねかむとるむ	タンネカムトルム	名詞
ばるおれがの	バル・オレガノ	名詞
ばんかくとう	蛮殻刀	名詞
びーとせいばー	ビートセイバー	名詞
ひきさき	ヒキサキ	名詞
びじん	尾刃	名詞
びじんをもすたち	尾刃を模す太刀	名詞
ひどぅんさーべる	ヒドゥンサーベル	名詞
ひもうたち	緋猛太刀	名詞
ひもうたち	緋猛太刀【天啓】	名詞
はくえんなぎ	白猿薙	名詞
ひゃくりゅうとう	百竜刀	名詞
ひょうじん	氷刃	名詞
ひょうじん	氷刃【雪月花】	名詞
せつげっか	氷刃【雪月花】	名詞
ひりゅうとう	飛竜刀	名詞
ひりゅうとう	飛竜刀【ベリル】	名詞
べりる	ベリル	名詞
ふうりゅうとう	封龍刀	名詞
ふうりゅうとう	封龍刀【破】	名詞
ふぉっくすくれすと	フォックスクレスト	名詞
ぶらいとせーばー	ブライトセーバー	名詞
ぶらっどくろす	ブラッドクロス	名詞
ぶるーとしゅてるん	ブルートシュテルン	名詞
ぶれいずしょてる	ブレイズショテル	名詞
ふろぎぃそーど	フロギィソード	名詞
べるだーさーべる	ベルダーサーベル	名詞
へるふれいむだんさー	ヘルフレイムダンサー	名詞
ほうとううことかむるばす	崩刀ウコトカムルバス	名詞
ほうとう	崩刀	名詞
うことかむるばす	ウコトカムルバス	名詞
ほうれんのきんぞくき	宝鎌の金属器	名詞
ほうれん	宝鎌	名詞
#ほね	骨	名詞
まがつたち	禍ツ太刀	名詞
まがつたち	禍ツ太刀【封】	名詞
まぐだふぁくるたす	マグダ・ファクルタス	名詞
まんさな	マンサナ	名詞
みらーじゅしょてる	ミラージュショテル	名詞
みらあんせすふぃあ	ミラアンセスフィア	名詞
みらざーげすぱのん	ミラザーゲスパノン	名詞
みらふぉてぃあ	ミラフォティア	名詞
めいえんざんとうぶろんて	冥淵斬刀ブロンテ	名詞
めいえんざんとう	冥淵斬刀	名詞
ぶろんて	ブロンテ	名詞
めいとうえんくりしす	冥刀エンクリシス	名詞
めいとう	冥刀	名詞
えんくりしす	エンクリシス	名詞
めろうぱう	メロウパウ	名詞
ものぶろすさいす	モノブロスサイス	名詞
やまなぎわいるどはいと	山薙ワイルドハイト	名詞
やまなぎ	山薙	名詞
わいるどはいと	ワイルドハイト	名詞
よろいりゅうのこうはとう	鎧竜乃紅破刀	名詞
こうはとう	紅破刀	名詞
らいじんじんらい	雷刀ジンライ	名詞
らいじん	雷刀	名詞
じんらい	ジンライ	名詞
らいとにんぐわーくす	ライトニングワークス	名詞
りっかたるひまる	六花垂氷丸	名詞
たるひまる	垂氷丸	名詞
りゅうとう	龍刀	名詞
りゅうぼくのたち	龍木ノ太刀	名詞
りゅうぼく	龍木	名詞
るぐれてゅれいら	ルグレ・テュレイラ	名詞
れすいーぶ	レス・イーブ	名詞
れすいーぶ	レス・イーブSP	名詞
れつせんとうるかすそりす	烈閃刀ルカスソリス	名詞
れつせんとう	烈閃刀	名詞
れつせんとう	ルカスソリス	名詞
れんきょくとう	連棘刀	名詞
れんごくをさいだんすきっさき	煉獄ヲ裁断ス切ッ先	名詞
ろうがとう	狼牙刀	名詞
ろうがとう	狼牙刀【悪獄】	名詞
あくごく	悪獄	名詞
ろーぐそーど	ローグソード	名詞
ろーぜんふぇーだー	ローゼンフェーダー	名詞
でぃーとぅ	D=トゥ	名詞
もんはんぶねっけつしどうしない	MH部熱血指導竹刀	名詞

##########
# 大剣
たいけん	大剣	名詞
あーすぱるす	アースパルス	名詞
あいしくるふぁんぐ	アイシクルファング	名詞
あいすうぃんぐ	アイスウィング	名詞
あかしまのしんたいけん	あかしまの神大剣	名詞
あぎと	アギト	名詞
あっしぇれべる	アッシェ・レベル	名詞
あにばーさりーそーど	アニバーサリーソード	名詞
あもんのけん	アモンの剣	名詞
あろえーにょ	アロエーニョ	名詞
あんぐいっしゅ	アングイッシュ	名詞
いんびじぶるあさしん	インビジブルアサシン	名詞
ゔぉるがべる	ヴォルガベル	名詞
えくすきゅーしょん	エクスキューション	名詞
えぴたふぷれーと	エピタフプレート	名詞
えむろーどういんぐ	エムロードウイング	名詞
えるどらぶれいど	エルドラブレイド	名詞
えんおうたいけん	炎王大剣	名詞
えんおうたいけん	炎王大剣【暴君】	名詞
えんおう	炎王	名詞
えんけんりおれうす	炎剣リオレウス	名詞
えんけん	炎剣	名詞
えんしぇんとぷれーと	エンシェントプレート	名詞
えんひたいけん	艶妃大剣	名詞
えんひたいけん	艶妃大剣【恒久】	名詞
えんぷれすがれあ	エンプレスガレア	名詞
おうがたいけん	王牙大剣	名詞
おうがたいけん	王牙大剣【黒雷】	名詞
こくらい	黒雷	名詞
おうこくきしたいけんふぇいす	王国騎士大剣フェイス	名詞
おおぶりなけんりんのかけら	大振りな剣鱗の欠片	名詞
けんりん	剣鱗	名詞
おにかなぼう	鬼金棒	名詞
おるどまきな	オルドマキナ	名詞
おるどまきな	オルドマキナ・GS	名詞
おるどまきなじーえす	オルドマキナ・GS	名詞
かいおうけんあんかりうす	海王剣アンカリウス	名詞
かいおうけん	海王剣	名詞
あんかりうす	アンカリウス	名詞
がいらぶれいず	ガイラブレイズ	名詞
がおれんずとぅーか	ガオレンズトゥーカ	名詞
かくおうけんあーてぃらーと	角王剣アーティラート	名詞
かくおうけん	角王剣	名詞
あーてぃらーと	アーティラート	名詞
かさいざん	火砕斬	名詞
かたらくとぶれいど	カタラクトブレイド	名詞
かほうたいけん【こくちょう】	華鳳大剣【黒蝶】	名詞
かむらのてつたいけん	カムラノ鉄大剣	名詞
かりばーん	カリバーン	名詞
きばおおかみけん	牙狼剣	名詞
かんなりのしんたいけん	かんなりの神大剣	名詞
きゃっとおぶごーるど	キャットオブゴールド	名詞
きゃぷてんJぶれいど	キャプテンJブレイド	名詞
きょうかがたきかいおがmkII	強化型機械大鋸mkII	名詞
きょうけん【むらくも】	凶剣【叢雲】	名詞
きょぎゅうのおおおの	巨牛の大斧	名詞
きょじゅうたいけん	巨獣大剣	名詞
きょりゅうけん【おりんぽす】	巨龍剣【オリンポス】	名詞
きりさき	キリサキ	名詞
ぎるおすぶれいど	ギルオスブレイド	名詞
ぎんよくのたいけん	銀翼の大剣	名詞
くおーらるほーん	クオーラルホーン	名詞
くどくたいけんあめじすと	苦毒大剣アメジスト	名詞
ぐらんしゃむしーる	グランシャムシール	名詞
ぐれーとしざー	グレートシザー	名詞
くれろぶれいど	クレロブレイド	名詞
ぐれんうぉる	グレンウォル	名詞
くろーむれいざー	クロームレイザー	名詞
くろがねそーど	クロガネソード	名詞
くろがねそーど	クロガネソードSP	名詞
こうこくたいけんあるれぼ	煌黒大剣アルレボ	名詞
とどろきたいけん【おうとら】	轟大剣【王虎】	名詞
つよしだんけんたるたろす	剛断剣タルタロス	名詞
きょっこうけんG-TUNE	極光剣G-TUNE	名詞
こくりゅうたいけん	刻竜大剣	名詞
ごしゃずばぁ	ゴシャズバァ	名詞
きつねたいけんはなやこよひの	狐大剣ハナヤコヨヒノ	名詞
ごるむぶれいど	ゴルム・ブレイド	名詞
さいれんとでぃけいど	サイレントディケイド	名詞
ざっしゅそーど	ザッシュソード	名詞
さびたたいけん	錆びた大剣	名詞
ざんしゅとう	ザンシュトウ	名詞
じーくむんと	ジークムント	名詞
じーくりんで	ジークリンデ	名詞
ししといふなのしろむくろ	獅子といふ名の白骸	名詞
しにがみもめっするあつきつるぎ	死神モ滅スル熱キ剣	名詞
じゃがんたいけん	邪眼大剣	名詞
しゃくえんのぶれいざー	灼炎のブレイザー	名詞
しゃくえん	灼炎	名詞
ぶれいざー	ブレイザー	名詞
じゃぐらすぶれいど	ジャグラスブレイド	名詞
じゃけん	蛇剣	名詞
じゅうげきていふ	重撃帝斧	名詞
しょうらいけん	召雷剣	名詞
しょうらいけん	召雷剣【麒麟】	名詞
しるむずぶれいど	シルムズブレイド	名詞
じんけん	仁剣	名詞
じんけん	仁剣【侠客立ち】	名詞
きょうかくだち	侠客立ち	名詞
しんごうだんけん	真・轟断剣	名詞
ごうだんけん	轟断剣	名詞
すいけんがのととす	水剣ガノトトス	名詞
すいけん	水剣	名詞
がのととす	ガノトトス	名詞
すかさりばしりしゃす	スカサリバシリシャス	名詞
すくらーが	スクラーガ	名詞
すてっきにまぜーる	ステッキニマゼール	名詞
すのうくらっど	スノウクラッド	名詞
すぱいくすらいさー	スパイクスライサー	名詞
すぱいくぶれいど	スパイクブレイド	名詞
せいゔざくいーん	セイヴザクイーン	名詞
せいりゅうとう	セイリュウトウ	名詞
ぜーげうぃんぐ	ゼーゲウィング	名詞
せきりゅうのたつつるぎ	赤龍ノ断ツ剣	名詞
ぜのまーりく	ゼノ＝マーリク	名詞
ぜの	ゼノ	名詞
まーりく	マーリク	名詞
そゔぁろふるみなんと	ソヴァロフルミナント	名詞
ぞくちょうのたいけん	族長の大剣	名詞
ぞくちょうのたいけん	族長の大剣【我王】	名詞
がおう	我王	名詞
たいけん	鯛剣	名詞
たいこうぼう	太公望	名詞
だおらでぐにだる	ダオラ＝デグニダル	名詞
だおら	ダオラ	名詞
でぐにだる	デグニダル	名詞
たかくきょうけん	多殻挟剣	名詞
たかくきょうけん	多殻挟剣【石楠花】	名詞
たかく	多殻	名詞
きょうけん	挟剣	名詞
しゃくなげ	石楠花	名詞
たつじんぶれいど	タツジンブレイド	名詞
だんじゃろ	ダン・ジャロ	名詞
ちぇーだあるざばる	チェーダアルザバル	名詞
つめたきつきのだんけん	冷たき月の断剣	名詞
だんけん	断剣	名詞
でぃしじょん	ディシジョン	名詞
でぃふぇんだー	ディフェンダー	名詞
てすかぶれいど	テスカブレイド	名詞
でするーとげいる	デスルート・ゲイル	名詞
でゅーくくれいもあ	デューククレイモア	名詞
てるまえろまえ	テルマエ・ロマエ	名詞
あまかけるたいけん	天翔大剣	名詞
てんろうたいけん	天狼大剣	名詞
てんろうたいけん	天狼大剣【月讀】	名詞
つくよみ	月讀	名詞
とうおうたいけん	凍王大剣	名詞
とうおうたいけん	凍王大剣【泡雪】	名詞
あわゆき	泡雪	名詞
どがんごくたいけん	弩岩獄大剣	名詞
どがんごくたいけん	弩岩獄大剣【重何断】	名詞
じゅうなんだん	重何断	名詞
どくかいちょうたいけん	毒怪鳥大剣	名詞
どくかいちょうたいけん	毒怪鳥大剣【劇薬】	名詞
どくのおう	毒ノ王	名詞
とくべつせいきかいおのこりゅうしき	特別製機械大鋸・龍式	名詞
とくべつせいきかいおのこ	特別製機械大鋸	名詞
りゅうしき	龍式	名詞
どはつたいは	怒髪大波	名詞
どはつたいは	怒髪大波【天城】	名詞
にげるもるす	ニゲル＝モルス	名詞
もるす	モルス	名詞
にふりーとどぅしゃー	ニフリートドゥシャー	名詞
にゅうかたなぐーく	入刀グーク	名詞
にゅくすれいざー	ニュクスレイザー	名詞
ねぶらぐらでぃうす	ネブラグラディウス	名詞
ねむりをさそうかいたいけん	睡りを誘う貝大剣	名詞
かいたいけん	貝大剣	名詞
ねるがるじゃっじ	ネルガルジャッジ	名詞
はおうたいけんがかむとるむ	覇皇大剣ガカムトルム	名詞
はおう	覇皇	名詞
がかむとるむ	ガカムトルム	名詞
はがんたいけんでぃおほこり	破岩大剣ディオホコリ	名詞
はがんたいけん	破岩大剣	名詞
でぃおほこり	ディオホコリ	名詞
はけんえむかむとるむ	覇剣エムカムトルム	名詞
はけん	覇剣	名詞
えむかむとるむ	エムカムトルム	名詞
はざくらきす	ハザクラキス	名詞
ばすたーそーど	バスターソード	名詞
ばとるくれいもあ	バトルクレイモア	名詞
はるばーど	ハルバード	名詞
ばるばろいぶれいど	バルバロイブレイド	名詞
ばんがさ	番傘	名詞
ぴっくぶれいど	ピックブレイド	名詞
ひっつぇゔぁっふぇ	ヒッツェ・ヴァッフェ	名詞
ひどぅんぶれいず	ヒドゥンブレイズ	名詞
ひゃくりゅうたいけん	百竜大剣	名詞
ひょうかいたいけん	氷塊大剣	名詞
ひょうかいたいけん	氷塊大剣【絶対零度】	名詞
ひょうりゅうしゃのかたな	漂流者の刀	名詞
ふうりゅうけん	封龍剣	名詞
ふうりゅうけん	封龍剣【滅一門】	名詞
めついちもん	滅一門	名詞
ふぉっくすぶれいど	フォックスブレイド	名詞
ふぉるてぺるふぇっと	フォルテペルフェット	名詞
ぶこつほうちょう	武骨包丁	名詞
ふっかつひりなーした	復活妃リナーシタ	名詞
ふっかつひ	復活妃	名詞
りなーした	リナーシタ	名詞
ぷらいどおぶしゃどう	プライドofシャドウ	名詞
ふらむえるへれゔ	フラムエルヘレヴ	名詞
ぶらんすらっしゃー	ブランスラッシャー	名詞
ぶりゅんひるで	ブリュンヒルデ	名詞
ぶるーむぶれいど	ブルームブレイド	名詞
ふるみなんとそーど	フルミナントソード	名詞
ふれああんさらー	フレアアンサラー	名詞
ぶれいずぶれいど	ブレイズブレイド	名詞
ふれいむみらぶれいど	フレイムミラブレイド	名詞
ぶろーどぶれいど	ブロードブレイド	名詞
べるだーぶれいど	ベルダーブレイド	名詞
ぼうきゃくのおすとらこん	忘却のオストラコン	名詞
おすとらこん	オストラコン	名詞
ほうけんうぇんかむるばす	崩剣ウェンカムルバス	名詞
ほうけん	崩剣	名詞
うぇんかむるばす	ウェンカムルバス	名詞
ぼうせつけん	暴雪剣	名詞
ぼうせつけん	暴雪剣【麒麟帝】	名詞
きりんてい	麒麟帝	名詞
ほうたいけんのきんぞくき	宝大剣の金属器	名詞
ほうたいけん	宝大剣	名詞
ほうまのつるぎ	ホウマノツルギ	名詞
ぼーんぶれいど	ボーンブレイド	名詞
ほるふぁるくす	ホルファルクス	名詞
ぼるぼぷれっしゃー	ボルボプレッシャー	名詞
まがつたいけん	禍ツ大剣	名詞
まがつたいけん	禍ツ大剣【封】	名詞
まぐだぽてすたす	マグダ・ポテスタス	名詞
まぐだ	マグダ	名詞
ぽてすたす	ポテスタス	名詞
まじでとぎしらず	マジデトギシラズ	名詞
みらあんせすぶれいど	ミラアンセスブレイド	名詞
みらぶれいど	ミラブレイド	名詞
むそうほうしん	無相法心	名詞
むそうほうしん	無相法心―不動―	名詞
むそうほうしんふどう	無相法心―不動―	名詞
めいえんたいけんふろが	冥淵大剣フロガ	名詞
めいえんたいけん	冥淵大剣	名詞
ふろが	フロガ	名詞
めがすわすたー	メガスワスター	名詞
めろうどろう	メロウドロウ	名詞
やくそくされたしょうりのけん	約束された勝利の剣	名詞
ゆにばーすくろむ	ユニバースクロム	名詞
よりきり	ヨリ斬リ	名詞
らいけんらぎあくるす	雷剣ラギアクルス	名詞
らいけん	雷剣	名詞
らぎあくるす	ラギアクルス	名詞
らるごえすぱーだ	ラルゴエスパーダ	名詞
りーむすくりんが	リームスクリンガ	名詞
りもせいばー	リモセイバー	名詞
りゅうねつきかんしき	竜熱機関式	名詞
りゅうねつきかんしき	竜熱機関式【鋼翼】	名詞
ごうよく	鋼翼	名詞
りゅうのこしかけ	リュウノコシカケ	名詞
れいとうまぐろ	レイトウマグロ	名詞
れふぃなえすぱるな	レフィナエスパルナ	名詞
ろうがたいけん	狼牙大剣	名詞
ろうがたいけん	狼牙大剣【辺獄】	名詞
へんごく	辺獄	名詞
ろーぜんぶれっと	ローゼンブレット	名詞
じーぶれいど	Gブレイド	名詞
よんじゅういちしきたいひりゅうたいけん	41式対飛竜大剣	名詞

##########
# 片手剣
かたてけん	片手剣	名詞
あいぎすふぉーす	アイギスフォース	名詞
あいすぶりーぜ	アイスブリーゼ	名詞
あかしまのしんけん	あかしまの神剣	名詞
あかしま	あかしま	名詞
しんけん	神剣	名詞
あじだはーか	ア・ジダハーカ	名詞
あずむくくり	アズムククリ	名詞
あるごぴたーれ	アルゴピターレ	名詞
あんくおぶちぇっかー	アンクofチェッカー	名詞
いーずるしっくる	イーズルシックル	名詞
いなずまわーくす	イナズマワークス	名詞
いふりーとまろう	イフリートマロウ	名詞
いんどら	インドラ	名詞
ゔぁしむあるま	ヴァシム・アルマ	名詞
ゔぁしむ	ヴァシム	名詞
あるま	アルマ	名詞
うぃっちゃーのぎんのつるぎ	ウィッチャーの銀の剣	名詞
うたつなぎのつるぎ	歌繋ノ剣	名詞
うるむーないふ	ウルムーナイフ	名詞
えすとれもだおら	エストレモ＝ダオラ	名詞
えすとれも	エストレモ	名詞
だおら	ダオラ	名詞
えむろーどれいぴあ	エムロードレイピア	名詞
えるどらくろーじゃー	エルドラクロージャー	名詞
えんおうけん	炎王剣	名詞
えんおうけん	炎王剣【爆龍】	名詞
ばくりゅう	爆龍	名詞
えんかくけん	炎角剣	名詞
えんかくけん	炎角剣【光炎】	名詞
こうえん	光炎	名詞
えんひけん	艶妃剣	名詞
えんひけん	艶妃剣【仮初】	名詞
#かりそめ	仮初	名詞
えんひけん	炎妃剣	名詞
えんひけん	炎妃剣【渇愛】	名詞
#かつあい	渇愛	名詞
えんぷれすえっじ	エンプレスエッジ	名詞
おうがけん	王牙剣	名詞
おうがけん	王牙剣【折雷】	名詞
せつらい	折雷	名詞
おうこくきしけんのーぶる	王国騎士剣ノーブル	名詞
おうごんじゅう棍	黄金獣棍	名詞
おうごんじゅう棍	黄金獣棍【狂】	名詞
#きょう	狂	名詞
おでっせいぶれいど	オデッセイブレイド	名詞
おるどまきな	オルドマキナ・SS	名詞
おるどまきな	オルドマキナ	名詞
おるどまきなえすえす	オルドマキナ・SS	名詞
がいらすらいさー	ガイラスライサー	名詞
かくりゅうけんくりむすれいぶ	角竜剣クリムスレイブ	名詞
かくりゅうけん	角竜剣	名詞
くりむすれいぶ	クリムスレイブ	名詞
かざんけんゔぉるくろす	火山剣ヴォルクロス	名詞
かざんけん	火山剣	名詞
ゔぉるくろす	ヴォルクロス	名詞
かむらのてっぺんじん	カムラノ鉄片刃	名詞
てっぺんじん	鉄片刃	名詞
がらてぃーん	ガラティーン	名詞
かんなりのしんけん	かんなりの神剣	名詞
ぎがすくらぶ	ギガスクラブ	名詞
きとうじって	鬼濤十手	名詞
きとう	鬼濤	名詞
きょうほう	凶宝	名詞
きょうほう	凶宝【翠嵐】	名詞
すいらん	翠嵐	名詞
きょじゅうけん	巨獣剣	名詞
きりかえし	斬リカエシ	名詞
きんぎゅうといふなのしろむくろ	金牛といふ名の白骸	名詞
きんじゅう棍	金獣棍	名詞
ぎんよくのそくけん	銀翼の速剣	名詞
ぎんよく	銀翼	名詞
そくけん	速剣	名詞
くけんあめじすとれいじ	苦剣アメジストレイジ	名詞
くけん	苦剣	名詞
あめじすとれいじ	アメジストレイジ	名詞
くっくどはつてん	クックドハツテン	名詞
ぐらんどがるせいん	グランドガルセイン	名詞
ぐれーとくくり	グレートククリ	名詞
くろおびそーど	クロオビソード	名詞
ごうけんあぐに	豪剣アグニ	名詞
ごうけん	豪剣	名詞
あぐに	アグニ	名詞
ごうけん	轟剣	名詞
ごうけん	轟剣【虎眼】	名詞
こがん	虎眼	名詞
こうこくけんあるすた	煌黒剣アルスタ	名詞
こうこく	煌黒剣	名詞
あるすた	アルスタ	名詞
こうりゅうけん	煌竜剣	名詞
ごーるどまろう	ゴールドマロウ	名詞
ごくこうまじゃりゅうけん	獄・紅魔邪龍剣	名詞
こうまじゃりゅうけん	紅魔邪龍剣	名詞
こくじゅ	黒呪	名詞
こくめつりゅうけん	黒滅龍剣	名詞
こくりゅうけん	黒龍剣	名詞
こくりゅうけん	刻竜剣	名詞
ごしゃざくぅ	ゴシャザクゥ	名詞
こせんはなのなごりを	狐扇ハナノナゴリヲ	名詞
こせん	狐扇	名詞
はなのなごりを	ハナノナゴリヲ	名詞
こだち	小太刀	名詞
こだち	小太刀【砂凪】	名詞
すななぎ	砂凪	名詞
ごるむそーど	ゴルム・ソード	名詞
ころな	コロナ	名詞
さーぺんとばいと	サーペントバイト	名詞
さきつめとごうひのたて	裂き爪と剛皮の盾	名詞
ざんじゃろ	ザン・ジャロ	名詞
さんどりよん	サンドリヨン	名詞
ざんぶれいど	ザンブレイド	名詞
しーすとらいかー	シーストライカー	名詞
しでん	紫電	名詞
しどうき	祀導器	名詞
しどうき	祀導器【一門外】	名詞
いちもんがい	一門外	名詞
しゃーどかったー	シャードカッター	名詞
しゃくえんのぷろみなー	灼炎のプロミナー	名詞
ぷろみなー	プロミナー	名詞
じゃぐらすえっじ	ジャグラスエッジ	名詞
しゃどうさーべる	シャドウサーベル	名詞
じゅおうけんちゃちゃぶー	呪王剣チャチャブー	名詞
じゅおう	呪王剣	名詞
ちゃちゃぶー	チャチャブー	名詞
じゅけん	珠剣	名詞
しゅらーふぁん	シュラーファン	名詞
しんのつるぎ	信の剣	名詞
しんぶらいけん	真舞雷剣	名詞
しんぶらいけん	真舞雷剣【鳳凰】	名詞
#ほうおう	鳳凰	名詞
すけいるそーど	スケイルソード	名詞
すごくふうかしたかたてけん	凄く風化した片手剣	名詞
すたーないとそーど	スターナイトソード	名詞
すぱいくえっじ	スパイクエッジ	名詞
せいしきさいようきかいきばのこ	正式採用機械牙鋸	名詞
きかいきばのこ	機械牙鋸	名詞
きばのこ	牙鋸	名詞
せきりゅうのさくきば	赤龍ノ裂ク牙	名詞
せくとせろ	セクトセロ	名詞
ぜのまぶーらー	ゼノ＝マブーラー	名詞
せりすせりあん	セリス・セリアン	名詞
そうよくけんしえるらみーな	蒼翼剣シエルラミーナ	名詞
そうよくけん	蒼翼剣	名詞
しえるらみーな	シエルラミーナ	名詞
そのははしょこうのごとし	其ノ刃ハ曙光ノ如シ	名詞
そりゅうれいけん	祖龍霊剣	名詞
そるじゃーだがー	ソルジャーダガー	名詞
だーてぃーぐらふ	ダーティーグラフ	名詞
だーどらうら	ダードラウラ	名詞
だおらくろむ	ダオラ＝クロム	名詞
だおらくろむ	ダオラ＝クロムSP	名詞
たからかたけん	多殻硬剣	名詞
たからかたけん	多殻硬剣【黒百合】	名詞
くろひゃくごう	黒百合	名詞
だちゅらぶろっさむ	ダチュラブロッサム	名詞
ちゅくちゅく	チュクチュク	名詞
つめたきつきのておの	冷たき月の手斧	名詞
#つるぎ	ツルギ	名詞
でぃおりもーと	ディオリモート	名詞
ておえんぶれむ	テオ＝エンブレム	名詞
ですぱらいず	デスパライズ	名詞
でするーとくれーる	デスルート・クレール	名詞
でゅあるからぺいす	デュアルカラペイス	名詞
でゅーくばぜらーど	デュークバゼラード	名詞
てんぐちょうぶくのつるぎ	天具・調伏の剣	名詞
てんしょうけん	天翔剣	名詞
あまかけるつるぎ	天翔剣	名詞
てんろうけん	天狼剣	名詞
てんろうけん	天狼剣【叢雲】	名詞
むらくも	叢雲	名詞
とうおうけん	凍王剣	名詞
とうおうけん	凍王剣【雨氷】	名詞
うひょう	雨氷	名詞
どがんごくけん	弩岩獄剣	名詞
どがんごくけん	弩岩獄剣【極良斬】	名詞
ごくりょうざん	極良斬	名詞
どくりゅうけん	独龍剣	名詞
どくりゅうけん	独龍剣【藍鬼】	名詞
あいおに	藍鬼	名詞
どすばいとだがー	ドスバイトダガー	名詞
どはつとっけん	怒髪突剣	名詞
どはつとっけん	怒髪突剣【慕情】	名詞
ぼじょう	慕情	名詞
どらぐろめいす	ドラグロメイス	名詞
とりあんぐらー	トリアングラー	名詞
なーぶあるふぁるど	ナーブアルファルド	名詞
なーるどぼっしぇ	ナールドボッシェ	名詞
にげるそる	ニゲル＝ソル	名詞
にゃんにゃんぼう	にゃんにゃんぼう	名詞
にんじゃそーど	ニンジャソード	名詞
ねぶらぼるぬす	ネブラボルヌス	名詞
ねむりをさそうかいけん	睡りを誘う貝剣	名詞
かいけん	貝剣	名詞
ねるがるじゃっく	ネルガルジャック	名詞
はいがのすすぱいく	ハイガノススパイク	名詞
はいどらばいと	ハイドラバイト	名詞
はおれのつるぎ	刃折れの剣	名詞
はがんけんですとるくじお	破岩剣デストルクジオ	名詞
はがんけん	破岩剣	名詞
ですとるくじお	デストルクジオ	名詞
ぱぎゅーるでるにえ	パギュールデルニエ	名詞
はしょうけんまきかむとるむ	覇小剣マキカムトルム	名詞
はしょうけん	覇小剣	名詞
まきかむとるむ	マキカムトルム	名詞
はめつのきりえ	破滅のキリエ	名詞
ぱらいずれいぴあ	パライズレイピア	名詞
ぱらいずれいぴあ	パライズレイピアSP	名詞
ぱらすぱいくさーくる	パラスパイクサークル	名詞
はんたーかりんが	ハンターカリンガ	名詞
はんたーないふ	ハンターナイフ	名詞
ひーろーぶれいど	ヒーローブレイド	名詞
ひどぅんえっじ	ヒドゥンエッジ	名詞
ひぷのえくすまきな	ヒプノ＝エクスマキナ	名詞
ひもうけん	緋猛剣	名詞
ひもうけん	緋猛剣【一閃】	名詞
いっせん	一閃	名詞
ひゃくりゅうけん	百竜剣	名詞
ひゅどろすでぃすく	ヒュドロスディスク	名詞
ひょうじんけんであどど	氷刃剣デア＝ドド	名詞
ひょうじんけん	氷刃剣デア＝ドド	名詞
ひょうじんけん	氷刃剣	名詞
であどど	デア＝ドド	名詞
ふぁるしおん	ファルシオン	名詞
ふうりゅうけん	封龍剣	名詞
ふうりゅうけん	封龍剣【絶一門】	名詞
ぜついちもん	絶一門	名詞
ふうりゅうほうけん	封龍宝剣	名詞
ふぇいたるゔぁいと	フェイタルヴァイト	名詞
ふぉーるふぇざー	フォールフェザー	名詞
ふぉっしるぎあ	フォッシルギア	名詞
ふがくたんけん	浮岳短剣	名詞
ふがくたんけん	浮岳短剣【桃源郷】	名詞
#とうげんきょう	桃源郷	名詞
ぶらっどたばるじん	ブラッドタバルジン	名詞
ふらむえるしーか	フラムエルシーカ	名詞
ぷりんせすれいぴあ	プリンセスレイピア	名詞
ふるれいざー	フルレイザー	名詞
ぶれいどしーるど	ブレイドシールド	名詞
ふろすとえっじ	フロストエッジ	名詞
ふろりすせいふ	フロリスセイフ	名詞
べるだーそーど	ベルダーソード	名詞
ぽいずんたばるじん	ポイズンタバルジン	名詞
ほうけんとほうじゅんのきんぞくき	宝剣と宝盾の金属器	名詞
ほうしゃきくきかむるばす	崩鉈キクキカムルバス	名詞
ほうしゃ	崩鉈	名詞
きくきかむるばす	キクキカムルバス	名詞
#ほうちょう	包丁	名詞
ぼーんくくり	ボーンククリ	名詞
ぼーんとまほーく	ボーントマホーク	名詞
まがつつるぎ	禍ツ剣	名詞
まがつつるぎ	禍ツ剣【封】	名詞
#ふう	封	名詞
まれかりんが	マレカリンガ	名詞
みょうほうおうしんれんげ	妙法応身―蓮華―	名詞
みょうほうおうしん	妙法応身	名詞
むーふぉーん	ムーフォーン	名詞
むしゃそなえ	武者備え	名詞
めいえんようけんかたふにあ	冥淵揺剣カタフニア	名詞
めいえんようけん	冥淵揺剣	名詞
かたふにあ	カタフニア	名詞
めらるーがじぇっと	メラルーガジェット	名詞
もうどくちょうけんげりょす	猛毒長剣ゲリョス	名詞
もうどくちょうけん	猛毒長剣	名詞
げりょす	ゲリョス	名詞
ものぶろすくらぶ	モノブロスクラブ	名詞
もるもるたーれ	モルモルターレ	名詞
もんちゃんぱぺっと	モンちゃんパペット	名詞
もんちゃん	モンちゃん	名詞
やまきざでんどろねです	山刻デンドロネデス	名詞
やまきざ	山刻	名詞
でんどろねです	デンドロネデス	名詞
ゆうしゃのつるぎ	勇者の剣	名詞
らーゔぁぴっかー	ラーヴァピッカー	名詞
らいけんころどらいと	雷剣コロドライト	名詞
らいけん	雷剣	名詞
ころどらいと	コロドライト	名詞
らいじんゔぁじゅら	雷刃ヴァジュラ	名詞
らいじん	雷刃	名詞
ゔぁじゅら	ヴァジュラ	名詞
らいでんぺっこ	ライデンペッコ	名詞
らいとばんぐ	ライトバング	名詞
らぎあそーど	ラギアソード	名詞
らっしゅたっぐ	ラッシュタッグ	名詞
りゅうれきいんせいしきたんけん	龍歴院正式短剣	名詞
りょうせいじゅうじぐらでぃあと	両聖十字グラディアト	名詞
りょうせいじゅうじ	両聖十字	名詞
ぐらでぃあと	グラディアト	名詞
るーきーないふ	ルーキーナイフ	名詞
れきせんのつるぎ	歴戦の剣	名詞
れつせんけんりゅみえーら	烈閃剣リュミエーラ	名詞
れむおるにすないふ	レムオルニスナイフ	名詞
ろあるどすくろう	ロアルドスクロウ	名詞
ろうがけん	狼牙剣	名詞
ろうがけん	狼牙剣【欲獄】	名詞
よくごく	欲獄	名詞
ろーぜんめっさー	ローゼンメッサー	名詞

##########
# 双剣
そうけん	双剣	名詞
あいるーくんめらるーくん	アイルー君メラルー君	名詞
あいすふぇざー	アイスフェザー	名詞
あかしまのしんじん	あかしまの神刃	名詞
しんじん	神刃	名詞
あきゅーとえっじ	アキュート・エッジ	名詞
あきゅーと	アキュート	名詞
あめざりくろう	アメザリクロウ	名詞
あるてみすのそうけん	アルテミスの双剣	名詞
いっかくそう	一角双	名詞
いっかくそう	一角双SP	名詞
いんせくとおーだー	インセクトオーダー	名詞
いんてらるゔぇっく	インテラルヴェック	名詞
ゔぇのむうぃんぐ	ヴェノムウィング	名詞
えいけつのくらうぃす	永訣のクラウィス	名詞
くらうぃす	クラウィス	名詞
えりもすりーでる	エリモスリーデル	名詞
えんひそう	炎妃双	名詞
えんひそう	炎妃双【悪女】	名詞
#あくじょ	悪女	名詞
えんひそうけん	艶妃双剣	名詞
えんひそうけん	艶妃双剣【純潔】	名詞
#じゅんけつ	純潔	名詞
えんぷれすだがー	エンプレスダガー	名詞
おうがそうじん	王牙双刃	名詞
おうがそうじん	王牙双刃【土雷】	名詞
どらい	土雷	名詞
おうこくきしそうけんうぃる	王国騎士双剣ウィル	名詞
そうけんうぃる	双剣ウィル	名詞
おうろうそうきば	王狼双牙	名詞
おうろうそうきば	王狼双牙【比叡】	名詞
#ひえい	比叡	名詞
おーだーれいぴあ	オーダーレイピア	名詞
おさのそうとう	長ノ双刀	名詞
おさのそうとう	長ノ双刀【不限】	名詞
ふきり	不限	名詞
おるどまきな	オルドマキナ	名詞
おるどまきな	オルドマキナ・DB	名詞
でぃーびー	DB	名詞
おれたきょうしゃ	折れた凶鉈	名詞
かいおうそうじんおせあのす	海王双刃オセアノス	名詞
かいおうそうじん	海王双刃	名詞
おせあのす	オセアノス	名詞
かいぞくじぇーえっじ	海賊Jエッジ	名詞
がいらだがー	ガイラダガー	名詞
がけつそうけんばるがるら	喰血双剣バルガルラ	名詞
がけつ	喰血	名詞
がけつそうけん	喰血双剣	名詞
ばるがるら	バルガルラ	名詞
かじんふぁいあすとーん	火刃ファイアストーン	名詞
かじん	火刃	名詞
がのかっとらす	ガノカットラス	名詞
かむらのてつそうじん	カムラノ鉄双刃	名詞
かりだんご	狩団子	名詞
かりだんご	狩団子【白玉】	名詞
しらたま	白玉	名詞
かりゅうもうそうけんそれいゆ	火竜猛双剣ソレイユ	名詞
かりゅうもうそうけん	火竜猛双剣	名詞
それいゆ	ソレイユ	名詞
かんなりのしんじん	かんなりの神刃	名詞
ぎあのすくろうず	ギアノスクロウズ	名詞
きかいはくりゅうそうけん	輝界白竜双剣	名詞
きかいはくりゅうそうけん	輝界白竜双剣【光嵐】	名詞
こうらん	光嵐	名詞
ぎがらんぽすくろうず	ギガランポスクロウズ	名詞
ぎがんとぴすとる	ギガントピストル	名詞
きじんそうこ	機神双鋸	名詞
きじん	機神	名詞
そうこ	双鋸	名詞
きめんかかし	奇面案山子	名詞
きゃっつねいるー	キャッツネイルー	名詞
きゃんどるえっじ	キャンドルエッジ	名詞
きょうせん	凶扇	名詞
きょうせん	凶扇【黒風白雨】	名詞
こくふうはくう	黒風白雨	名詞
きょくしょくそうろーぜんえっじ	棘蝕双ローゼンエッジ	名詞
きょくしょくそう	棘蝕双	名詞
ろーぜんえっじ	ローゼンエッジ	名詞
きょじゅうそうけん	巨獣双剣	名詞
きんじんしょうりゅうそうけん	金塵翔龍双剣	名詞
きんじんしょうりゅうそうけん	金塵翔龍双剣【風刻】	名詞
ふうこく	風刻	名詞
ごくあんこくじゃりゅうそうけん	極・闇黒邪龍双剣	名詞
あんこくじゃりゅうそうけん	闇黒邪龍双剣	名詞
きれあじせーばー	キレアジセーバー	名詞
ぎんよくのそうじん	銀翼の双刃	名詞
そうじん	双刃	名詞
くーらーだがー	クーラーダガー	名詞
くっくついんず	クックツインズ	名詞
くっくでゅある	クックデュアル	名詞
くっくでゅある	クックデュアル【特】	名詞
#とく	特	名詞
ぐらいめでゅーさ	グライメデューサ	名詞
くらぶほーん	クラブホーン	名詞
ぐれんばくえんじん	紅蓮爆炎刃	名詞
くろうおぶりっぱー	クロウofリッパー	名詞
くろとげをたばねしやいば	黒棘を束ねし刃	名詞
げきりゅうのつがい	ゲキリュウノツガイ	名詞
こうけんさいふぁー	光剣サイファー	名詞
こうけん	光剣	名詞
さいふぁー	サイファー	名詞
こうこくそうけんあるぶれ	煌黒双剣アルブレ	名詞
こうこく	煌黒	名詞
あるぶれ	アルブレ	名詞
ごうそう	轟爪	名詞
ごうそう	轟爪【虎血】	名詞
とらち	虎血	名詞
こうひょうろうが	鋼氷狼牙	名詞
こうぶへきざんそう	紅舞碧斬双	名詞
こうりゅうそうりゅうのたましいのつるぎ	紅竜蒼竜ノ魂ノ剣	名詞
こうりゅうのせきそうけん	鋼龍の石双剣	名詞
せきそうけん	石双剣	名詞
こーれじゅーぐ	コーレジューグ	名詞
ごくらいざん	極雷斬	名詞
ごくらいざん	極雷斬【鳴神】	名詞
なるかみ	鳴神	名詞
こくりゅうそうじん	黒龍双刃	名詞
こくろうそうじん	黒狼双刃	名詞
こそうじんあかつきのそら	狐双刃アカツキノソラ	名詞
こそうじん	狐双刃	名詞
あかつきのそら	アカツキノソラ	名詞
こばるとしざー	コバルトシザー	名詞
ごるむごれむ	ゴルム・ゴレム	名詞
さいくろん	サイクロン	名詞
ざくんあるぎえば	ザクンアルギエバ	名詞
ざざみくろうず	ザザミクロウズ	名詞
ざっつおーる	ザッツオール	名詞
さらまんだー	サラマンダー	名詞
しーらもふもふ	シーラモフモフ	名詞
じぇびあふぇくす	ジェビアフェクス	名詞
しえろつーる	シエロツール	名詞
してんそうかく	司天双角	名詞
しほうきじん	四方鬼刃	名詞
じゃぎっとしょてる	ジャギットショテル	名詞
しゃくえんのろがー	灼炎のロガー	名詞
しゃくこうそうそう	灼鋼双爪	名詞
じるえあえる	ジルエアエル	名詞
しるむずべねっと	シルムズベネット	名詞
しんぶらいそう	真舞雷双	名詞
しんぶらいそう	真舞雷双【迦楼羅】	名詞
かるら	迦楼羅	名詞
じんらいわーくす	ジンライワークス	名詞
すいさいごくそうけん	水砦獄双剣	名詞
すいさいごくそうけん	水砦獄双剣【万水】	名詞
ばんすい	万水	名詞
すのうついんず	スノウツインズ	名詞
せいゆうそうえつ	青熊双鉞	名詞
せきりゅうのまうつめ	赤龍ノ舞ウ爪	名詞
せつでぃー	セツ=D	名詞
ぜらいしんそうけん	絶雷振双剣	名詞
せんせんぶじんれむじぇーど	戦扇舞刃レムジェード	名詞
せんせんぶじん	戦扇舞刃	名詞
れむじぇーど	レムジェード	名詞
そうえん	双焔	名詞
そうふ	蒼斧	名詞
そうふ	蒼斧【焼灼】	名詞
しょうしゃく	焼灼	名詞
そうおんそうけん	創音双剣	名詞
そうおんそうけん	創音双剣【暁鐘】	名詞
ぎょうしょう	暁鐘	名詞
そうきょくけんろわーが	双曲剣ロワーガ	名詞
そうきょくけん	双曲剣	名詞
ろわーが	ロワーガ	名詞
そうじといふなのしろむくろ	双児といふ名の白骸	名詞
そうしょうおうらんそう	蒼翔桜乱双	名詞
そうせいのぐれんじん	双星の紅蓮刃	名詞
そうせい	双星	名詞
ぐれんじん	紅蓮刃	名詞
そうてっせん	双鉄扇	名詞
そうてっせん	双鉄扇【ガバス】	名詞
がばす	ガバス	名詞
そうらい	双雷	名詞
そうらい	双雷【極】	名詞
# きょく	極	名詞
そうらいけんきりん	双雷剣キリン	名詞
そうらいけん	双雷剣	名詞
そうりゅうけん	双龍剣	名詞
そうりゅうじん	双龍刃	名詞
そうりゅうじん	双龍刃【紅空闇夜】	名詞
こうくうあんや	紅空闇夜	名詞
そうりゅうじん	双龍神	名詞
そうりゅうじん	双龍神【黒天白夜】	名詞
こくてんびゃくや	黒天白夜	名詞
だーいんすれいゔ	ダーインスレイヴ	名詞
たれあちぇるかとーれ	タレアチェルカトーレ	名詞
たろんぶろす	タロンブロス	名詞
ちょうこうしつぶれーど	超硬質ブレード	名詞
たいけんゔぉるととす	対剣ヴォルトトス	名詞
たいけん	対剣	名詞
ゔぉるととす	ヴォルトトス	名詞
ついすとるくる	ツイストルクル	名詞
ついんくるす	ツインクルス	名詞
ついんだがー	ツインダガー	名詞
ついんぼると	ツインボルト	名詞
ついんれぎーな	ツインレギーナ	名詞
つめたきつきのしゅそう	冷たき月の朱爪	名詞
でぃあずろっく	ディアズロック	名詞
ていせいそうけん	帝征双剣	名詞
ですぺらーど	デスペラード	名詞
てっせん	テッセン	名詞
でゅあるとまほーく	デュアルトマホーク	名詞
でゅーくはーけん	デュークハーケン	名詞
でんせつのそうじん	伝説の双刃	名詞
とうき	闘鬼	名詞
とうき	闘鬼【高丸】	名詞
たかまる	高丸	名詞
とがゆるすかてんのりょうしょう	咎赦ス火天ノ両掌	名詞
どどんしざー	ドドン・シザー	名詞
どはつそうらん	怒髪双乱	名詞
どはつそうらん	怒髪双乱【挽歌】	名詞
ばんか	挽歌	名詞
にゔるぷりざーど	ニヴルプリザード	名詞
にげるにんぶす	ニゲル＝ニンブス	名詞
ねぐるどあーだ	ネグルドアーダ	名詞
ねっらずーろぜろす	ネッラズーロ・ゼロス	名詞
ねっらずーろ	ネッラズーロ	名詞
ぜろす	ゼロス	名詞
ねるがるがうじ	ネルガルガウジ	名詞
はいついんだがー	ハイツインダガー	名詞
はがんそうじんあるこばれの	破岩双刃アルコバレノ	名詞
はがんそうじん	破岩双刃	名詞
あるこばれの	アルコバレノ	名詞
ばくりんのておの	爆鱗の手斧	名詞
ばくろうそうけん	爆狼双剣	名詞
ばくろうそうけん	爆狼双剣【シュン】	名詞
ばさるぐらんで	バサルグランデ	名詞
はこうそうてらかむとるむ	覇皇爪テラカムトルム	名詞
はこうそう	覇皇爪	名詞
てらかむとるむ	テラカムトルム	名詞
はそうあむるかむとるむ	覇爪アムルカムトルム	名詞
はそう	覇爪	名詞
あむるかむとるむ	アムルカムトルム	名詞
はそうあるかむとるむ	覇双アルカムトルム	名詞
はそう	覇双	名詞
あるかむとるむ	アルカムトルム	名詞
ばるろん	バル・ロン	名詞
はんばはきばりゅうかくとうじゅつ	範馬刃牙流格闘術	名詞
ひしんけんちゃなぱるす	痺針剣チャナパルス	名詞
ひしん	痺針剣	名詞
ちゃなぱるす	チャナパルス	名詞
びーくだがー	ビークダガー	名詞
ひどぅがー	ヒドゥガー	名詞
ひもうそうけん	緋猛双剣	名詞
ひもうそうけん	緋猛双剣【神速】	名詞
しんそく	神速	名詞
ひゃくりゅうそうじん	百竜双刃	名詞
ひゅぷのかったー	ヒュプノカッター	名詞
ひょうえんけんゔぃるまふれあ	氷炎剣ヴィルマフレア	名詞
ひょうえんけん	氷炎剣	名詞
ゔぃるまふれあ	ヴィルマフレア	名詞
ぴんくぼんぼん	ピンクボンボン	名詞
ふうりゅうけん	封龍剣	名詞
ふうりゅうけん	封龍剣【超絶一門】	名詞
ちょうぜついちもん	超絶一門	名詞
ふらむえるくるて	フラムエルクルテ	名詞
ぶらんはちぇっと	ブランハチェット	名詞
ふらんべろじゅ	フランベロジュ	名詞
ぶりざーどふぁんぐ	ブリザードファング	名詞
ふるーじぇんとだがー	フルージェントダガー	名詞
ふろーずんくりーばー	フローズンクリーバー	名詞
ぶろすぶろす	ブロスブロス	名詞
ふわふわのじあい	フワフワの慈愛	名詞
べるだーだがー	ベルダーダガー	名詞
ほうじんのついなるきんぞくき	宝刃の対なる金属器	名詞
ほうじん	宝刃	名詞
ほうじんやっかむるばす	崩刃ヤッカムルバス	名詞
ほうじん	崩刃	名詞
やっかむるばす	ヤッカムルバス	名詞
ぼーんしっくる	ボーンシックル	名詞
ぽっけみとん	ポッケミトン	名詞
ほろよいびーあ	ほろ酔いビーア	名詞
まがつやいば	禍ツ刃	名詞
まがつやいば	禍ツ刃【封】	名詞
#ふう	封	名詞
まぐだうんぐら	マグダ・ウングラ	名詞
まくろぴあさー	マクロピアサー	名詞
まつりばやしせいらんのちょう	祭囃子・晴嵐ノ調	名詞
みるとてゅれいら	ミルト・テュレイラ	名詞
めいえんそうじんるなりよす	冥淵双刃ルナリヨス	名詞
めいえんそうじん	冥淵双刃	名詞
るなりよす	ルナリヨス	名詞
めいそうけんえんとらーじ	冥双剣エントラージ	名詞
めいそうけん	冥双剣	名詞
えんとらーじ	エントラージ	名詞
めるとうぉーりあ	メルトウォーリア	名詞
めろうくろう	メロウクロウ	名詞
やつざき	ヤツザキ	名詞
らーすぷれでたー	ラースプレデター	名詞
らすとたばるじん	ラストタバルジン	名詞
らふぁーるだおら	ラファール＝ダオラ	名詞
らんぽすくろうず	ランポスクロウズ	名詞
りゅうげきのそうじん	龍撃の双刃	名詞
りゅうげきのそうじん	龍撃の双刃SP	名詞
るどろすついんず	ルドロスツインズ	名詞
れいにぃじぇりぃ	レイニィ・ジェリィ	名詞
れうすくろうず	レウスクロウズ	名詞
れっせんそうけんさんしーん	烈閃双剣サンシーン	名詞
れっせんそうけん	烈閃双剣	名詞
さんしーん	サンシーン	名詞
りゅうれきいんせいしきそうけん	龍歴院正式双剣	名詞
ろーぜんつぁーん	ローゼンツァーン	名詞
ろーれらいりーべ	ローレライ・リーべ	名詞
もんはんぶいんとくせいせんす	MH部員特製扇子	名詞
ごーいちしきぶそうこんぼう	51式武装棍棒	名詞

