# Thx
# https://wikiwiki.jp/nenaiko/
# https://a-to-monhan.com/2020/12/28/rise-kannji-yomikata/

##########
# スキル
# あ行
あいき	合気	名詞
あいてむしようきょうか	アイテム使用強化	名詞
うたかたのまい	泡沫の舞	名詞
えんりんのおんけい	炎鱗の恩恵	名詞
おにびまとい	鬼火纏	名詞
# か行
がーどきょうか	ガード強化	名詞
がおーどせいのう	ガード性能	名詞
かいしんげきぞくせい	会心撃【属性】	名詞
かいひりつあっぷ	回避距離UP	名詞
かいひせいのう	回避性能	名詞
かいふくそくど	回復速度	名詞
かけりむしつかい	翔蟲使い	名詞
かじばりょく	火事場力	名詞
かすみがわのおんけい	霞皮の恩恵	名詞
かぜまとい	風纏	名詞
かっそうきょうか	滑走強化	名詞
かみなりぞくせいきょうか	雷属性攻撃強化	名詞
かみなりたいせい	雷耐性	名詞
かんしょう	緩衝	名詞
かんつうだんかんつうやきょうか	貫通弾・貫通矢強化	名詞
きぜつたいせい	気絶耐性	名詞
きのこだいすき	キノコ大好き	名詞
ぎゃくしゅう	逆襲	名詞
きょうおう	供応	名詞
きょうか	狂化	名詞
きょうかじぞく	強化持続	名詞
きょうりゅうしょう	狂竜症	名詞
きょうりゅうしょうしょう	狂竜症【翔】	名詞
きょうりゅうしょうしょく	狂竜症【蝕】	名詞
けーおーじゅつ	KO術	名詞
けっき	血氣	名詞
けっきかくせい	血氣覚醒	名詞
げきこう	激昂	名詞
けんにょばんじゃく	顕如盤石	名詞
けんまじゅつ	研磨術	名詞
けんまじゅつえい	研磨術【鋭】	名詞
こういきか	広域化	名詞
こううん	幸運	名詞
ごうがい	業鎧	名詞
ごうがいしゅら	業鎧【修羅】	名詞
こうかくのおんけい	鋼殻の恩恵	名詞
こうせい	攻勢	名詞
こうげき	攻撃	名詞
こうげき	巧撃	名詞
うまげき	巧撃	名詞
ごうしん	剛心	名詞
ごうじんけんま	剛刃研磨	名詞
こうそくへんけい	高速変形	名詞
こおりぞくせいきょうか	氷属性攻撃強化	名詞
こおりたいせい	氷耐性	名詞
こんじょう	根性	名詞
こんしん	渾身	名詞
# さ行
さいかてんぷく	災禍転福	名詞
さかうらみ	逆恨み	名詞
さんだんかくさんやきょうか	散弾・拡散矢強化	名詞
しちゅうにかつ	死中に活	名詞
じゃくてんとっこう	弱点特効	名詞
じゃくてんとっこうぞくせい	弱点特効【属性】	名詞
じゃんぷてつじん	ジャンプ鉄人	名詞
しゅうちゅう	集中	名詞
じょうたいいじょうちくせき	状態異常確定蓄積	名詞
しょくせいがく	植生学	名詞
しんがん	心眼	名詞
じんりんみがき	刃鱗磨き	名詞
すいみんぞくせいきょうか	睡眠属性強化	名詞
すいみんたいせい	睡眠耐性	名詞
すたみなきゅうそくかいふく	スタミナ急速回復	名詞
すたみなだっしゅ	スタミナ奪取	名詞
せいれいのかご	精霊の加護	名詞
せめのしゅせい	攻めの守勢	名詞
せんえい	煽衛	名詞
そうてんかくちょう	装填拡張	名詞
そうてんそくど	装填速度	名詞
そくどきょうか	速射強化	名詞
ぞくせいやられたいせい	属性やられ耐性	名詞
# た行
たいじゅつ	体術	名詞
たいしん	耐震	名詞
たいりょくかいふくりょうあっぷ	体力回復量UP	名詞
たくみ	匠	名詞
たつじんげい	達人芸	名詞
だんがんせつやく	弾丸節約	名詞
だんどうきょうか	弾導強化	名詞
ちからのかいほう	力の解放	名詞
ちくせきじこうげききょうか	蓄積時攻撃強化	名詞
ちしつがく	地質学	名詞
ちゃーじますたー	チャージマスター	名詞
ちゅーんあっぷ	チューンアップ	名詞
ちょうかいしん	超会心	名詞
ちょうせんしゃ	挑戦者	名詞
つうじょうだんれんしゃやきょうか	通常弾・連射矢強化	名詞
てんいむほう	天衣無崩	名詞
といししようそくか	砥石使用高速化	名詞
とくしゅしゃげききょうか	特殊射撃強化	名詞
どくぞうせいきょうか	毒属性強化	名詞
どぐたいせい	毒耐性	名詞
とびこみ	飛び込み	名詞
でいせつたいせい	泥雪耐性	名詞
どんきつかい	鈍器使い	名詞
# な行
のうとうじゅつ	納刀術	名詞
のりめいじん	乗り名人	名詞
# は行
はかいおう	破壊王	名詞
はぎとりてつじん	剥ぎ取り鉄人	名詞
はぎとりめいじん	剥ぎ取り名人	名詞
ばくはぞくせいきょうか	爆破属性強化	名詞
ばくはやられたいせい	爆破やられ耐性	名詞
ばっとうじゅつ	抜刀術	名詞
ばっとうじゅつちから	抜刀術【力】	名詞
ばっとうじゅつわざ	抜刀術【技】	名詞
はやぐい	早食い	名詞
はやてのいぶき	疾之息吹	名詞
はらへりたいせい	腹減り耐性	名詞
はんどうけいげん	反動軽減	名詞
ひぞくせいきょうか	火属性攻撃強化	名詞
ひたいせい	火耐性	名詞
ひるみけいげん	ひるみ軽減	名詞
ひょうきれんせい	冰気錬成	名詞
ふうあつたいせい	風圧耐性	名詞
ふうもんのいっち	風紋の一致	名詞
ふうじんごういつ	風雷合一	名詞
ふえふきめいじん	笛吹き名人	名詞
ふくつ	不屈	名詞
ふくまきょうめい	伏魔響命	名詞
ふるちゃーじ	フルチャージ	名詞
ぶれよくせい	ブレ抑制	名詞
ふんじんまとい	粉塵纏	名詞
ふんとう	奮闘	名詞
へきめんいどう	壁面移動	名詞
へきめんいどうしょう	壁面移動【翔】	名詞
ぼうぎょ	防御	名詞
ほうじゅつ	砲術	名詞
ほうだんそうてん	砲弾装填	名詞
ほかくめいじん	捕獲名人	名詞
ぼまー	ボマー	名詞
# ま行
まひぞくせいきょうか	麻痺属性強化	名詞
まひたいせい	麻痺耐性	名詞
まんぞくかん	満足感	名詞
みきり	見切り	名詞
みずぞくせいきょうか	水属性攻撃強化	名詞
みずたいせい	水耐性	名詞
みみせん	耳栓	名詞
# や行
やみうち	闇討ち	名詞
ゆみだめだんかいかいほう	弓溜め段階解放	名詞
ようどう	陽動	名詞
# ら行
らいもんのいっち	雷紋の一致	名詞
らんなー	ランナー	名詞
りゅうきかっせい	龍気活性	名詞
りゅうきへんかん	龍気変換	名詞
りゅうぞくせいきょうか	龍属性攻撃強化	名詞
りゅうたいせい	龍耐性	名詞
れんげき	連撃	名詞
# わ行
わざもの	業物	名詞

