# Thx
# https://wikiwiki.jp/nenaiko/
# https://a-to-monhan.com/2020/12/28/rise-kannji-yomikata/

# 装備(防具,装飾品)

##########
# 防具
へるむ	ヘルム	名詞
めいる	メイル	名詞
あーむ	アーム	名詞
こいる	コイル	名詞
ぶーつ	ブーツ	名詞
あーく	アーク	名詞
ふぃりあ	フィリア	名詞
あいるーふぇいく	アイルーフェイク	名詞
あかつきまる	暁丸	名詞
りん	凛	名詞
あかむと	アカムト	名詞
あぐな	アグナ	名詞
あくら	アクラ	名詞
あけの	アケノ	名詞
あしら	アシラ	名詞
あすとら	アストラ	名詞
あすりすた	アスリスタ	名詞
あすーる	アスール	名詞
あのる	アノル	名詞
あめざり	アメザリ	名詞
あるてみす	アルテミス	名詞
あるてら	アルテラ	名詞
あるぶーろ	アルブーロ	名詞
あろい	アロイ	名詞
あんがるだ	アンガルダ	名詞
いーおす	イーオス	名詞
いなり	稲荷	名詞
たまも	玉藻	名詞
いぎょう	異形	名詞
いずち	イズチ	名詞
いそね	イソネ	名詞
いりーく	イリーク	名詞
いんごっと	インゴット	名詞
ゔぁちす	ヴァチス	名詞
ぷらぐま	プラグマ	名詞
うーろん	ウーロン	名詞
うかむる	ウカムル	名詞
うしおへっど	うしおヘッド	名詞
うしおへあ	うしおヘア	名詞
うつしおもて	ウツシ表	名詞
うつしうら	ウツシ裏	名詞
よりまし	依巫	名詞
かんなぎ	神凪	名詞
うるく	ウルク	名詞
うるず	ウルズ	名詞
うるむー	ウルムー	名詞
ゔぁいく	ヴァイク	名詞
ゔぁる	ヴァル	名詞
えーす	エース	名詞
くいーん	クイーン	名詞
えーでる	エーデル	名詞
えすかどら	エスカドラ	名詞
えすぴな	エスピナ	名詞
えみーるふぇいく	エミールフェイク	名詞
えんとら	エントラ	名詞
えんぷれす	エンプレス	名詞
おうこくきし	王国騎士	名詞
おうじゃ	王者	名詞
きょうしゃ	強者	名詞
おうびーと	オウビート	名詞
ぱぴめる	パピメル	名詞
おーぐ	オーグ	名詞
おでぃば	オディバ	名詞
おろみど	オロミド	名詞
がーぐぁふぇいく	ガーグァフェイク	名詞
がーでぃあん	ガーディアン	名詞
かーまいん	カーマイン	名詞
さじたりお	サジタリオ	名詞
かいざー	カイザー	名詞
かいじ	カイジ	名詞
びしん	美心	名詞
むくろそうこう	骸装甲	名詞
かばねそうこう	屍装甲	名詞
かいぞくじぇー	海賊J	名詞
かがち	カガチ	名詞
かくじゅのはねかざり	鶴寿の羽飾り	名詞
かくじゅ	鶴寿	名詞
がこう	雅孔	名詞
がせん	雅穿	名詞
かつぼうのぴあす	渇望のピアス	名詞
がのす	ガノス	名詞
かぶら	カブラ	名詞
がぶらすーつ	ガブラスーツ	名詞
がぶる	ガブル	名詞
がむーと	ガムート	名詞
かむらのそう	カムラノ装	名詞
がらら	ガララ	名詞
がるるが	ガルルガ	名詞
がれおす	ガレオス	名詞
がろん	ガロン	名詞
がんきん	ガンキン	名詞
ぎえな	ギエナ	名詞
ぎざみ	ギザミ	名詞
きじん	鬼神	名詞
どうじ	童子	名詞
きのす	キノス	名詞
きゃぷてんじぇー	キャプテンJ	名詞
きゅーる	キュール	名詞
きりはな	桐花	名詞
みつき	三葵	名詞
きりん	キリン	名詞
ぎるどこうけんしょうぴあす	ギルド貢献証ピアス	名詞
ぎるどばーど	ギルドバード	名詞
ぎるどないと	ギルドナイト	名詞
ぎろろふぇいく	ギロロフェイク	名詞
きんぐろぶすた	キングロブスタ	名詞
くくぼ	ククボ	名詞
くしゃな	クシャナ	名詞
くっく	クック	名詞
ぐらびど	グラビド	名詞
ぐるにゃん	グルニャン	名詞
くるる	クルル	名詞
ぐれん	グレン	名詞
ぐろーしあ	グローシア	名詞
くろおび	クロオビ	名詞
くろむめたる	クロムメタル	名詞
くんちゅうあーむ	クンチュウアーム	名詞
くんれんへいだん	訓練兵団	名詞
けいおす	ケイオス	名詞
ねふぃりむ	ネフィリム	名詞
けちゃ	ケチャ	名詞
げねぽす	ゲネポス	名詞
げりょす	ゲリョス	名詞
けんせいのぴあす	剣聖のピアス	名詞
けんせい	剣聖	名詞
ごあ	ゴア	名詞
こうてん	荒天	名詞
そうてん	蒼天	名詞
ごーるどるな	ゴールドルナ	名詞
ごぎょう	ゴギョウ	名詞
ごぐ	ゴグ	名詞
まごぐ	マゴグ	名詞
ごしゃ	ゴシャ	名詞
ことる	コトル	名詞
こりにぃ	コリニィ	名詞
こるーで	コルーデ	名詞
ごるむ	ゴルム	名詞
ごん	ゴン	名詞
こんが	コンガ	名詞
きむごう	金剛	名詞
ふどう	不動	名詞
きんいろ	金色	名詞
くろこ	黒子	名詞
こんとんのぱお	混沌のパオ	名詞
こんとん	混沌	名詞
ぱお	パオ	名詞
さーじゅ	サージュ	名詞
ざざみ	ザザミ	名詞
ざぼあ	ザボア	名詞
さんがん	三眼	名詞
ざんよう	残陽	名詞
ときわ	常磐	名詞
しーかー	シーカー	名詞
しのび	忍	名詞
しまき	しまき	名詞
じゃぎぃ	ジャギィ	名詞
じゃぐらす	ジャグラス	名詞
しゃどうあい	シャドウアイ	名詞
じゃなふ	ジャナフ	名詞
しゃむ	シャム	名詞
じゅら	ジュラ	名詞
しょうじんはのはねかざり	隼刃の羽飾り	名詞
しょうじんは	隼刃	名詞
じょうさいゆうげきたい	城塞遊撃隊	名詞
じょうさいきゅうげきたい	城塞弓撃隊	名詞
しょうろう	ショウロウ	名詞
みたま	ミタマ	名詞
しるばーそる	シルバーソル	名詞
じんおう	ジンオウ	名詞
すーつ	スーツ	名詞
すからー	スカラー	名詞
すかるだ	スカルダ	名詞
すぱいお	スパイオ	名詞
すかるふぇいす	スカルフェイス	名詞
すきゅら	スキュラ	名詞
すてぃーる	スティール	名詞
すとろま	ストロマ	名詞
すねーく	スネーク	名詞
ざぼす	ザ・ボス	名詞
ずわろ	ズワロ	名詞
せいらー	セイラー	名詞
せーりお	セーリオ	名詞
しゃるまん	シャルマン	名詞
ぜくす	ゼクス	名詞
ぜのらーじ	ゼノラージ	名詞
せりえなさい	セリエナ祭	名詞
せるたす	セルタス	名詞
ぞうだんのぴあす	増弾のピアス	名詞
ぞうだん	増弾	名詞
ぞでぃあす	ゾディアス	名詞
ぞでっく	ゾデック	名詞
ぞらまぐな	ゾラマグナ	名詞
だいかいぞくじぇー	大海賊J	名詞
たかみのぴあす	鷹見のピアス	名詞
たかみ	鷹見	名詞
だすく	ダスク	名詞
だますく	ダマスク	名詞
たろす	タロス	名詞
ちじょうさいきょう	地上最強	名詞
ちぇーん	チェーン	名詞
ちょうぜつのぴあす	超絶のピアス	名詞
ちりゃくのめがね	知略の眼鏡	名詞
でぃあぶろ	ディアブロ	名詞
でぃおれ	ディオレ	名詞
でぃす	ディス	名詞
でぃの	ディノ	名詞
ですぎあ	デスギア	名詞
てんご	テンゴ	名詞
でんせつじぇー	伝説J	名詞
てんたくる	テンタクル	名詞
どぅんる	ドゥンル	名詞
どーべる	ドーベル	名詞
どぼる	ドボル	名詞
どらごん	ドラゴン	名詞
とるぺど	トルペド	名詞
どろす	ドロス	名詞
どんぐり	どんぐり	名詞
なでしこ	撫子	名詞
ききょう	桔梗	名詞
なるが	ナルガ	名詞
なるかみ	なるかみ	名詞
にせたま	ニセたま	名詞
ねせと	ネセト	名詞
ねぶら	ネブラ	名詞
のわーる	ノワール	名詞
はーゔぇすと	ハーヴェスト	名詞
はいめた	ハイメタ	名詞
はいりあ	ハイリア	名詞
ばぎぃ	バギィ	名詞
ばさる	バサル	名詞
ばぜる	バゼル	名詞
ぱっしょん	パッション	名詞
ぱてぃしえ	パティシエ	名詞
ばとる	バトル	名詞
はぷる	ハプル	名詞
ばりあすーつ	バリアスーツ	名詞
ぜろすーつ	ゼロスーツ	名詞
ばるく	バルク	名詞
ばるばにあ	バルバニア	名詞
ばれった	バレッタ	名詞
ばんぎす	バンギス	名詞
はんたー	ハンター	名詞
はんと	ハント	名詞
はんにん	犯人	名詞
ひーらー	ヒーラー	名詞
びすとろ	ビストロ	名詞
ひぷの	ヒプノ	名詞
ひりゅうの	飛竜ノ	名詞
ふぁみつうてぃーしゃつ	ファミ通Tシャツ	名詞
ふぁんご	ファンゴ	名詞
ぷけぷけ	プケプケ	名詞
ぶなは	ブナハ	名詞
ぷらいべーと	プライベート	名詞
ぶらき	ブラキ	名詞
ぶらっく	ブラック	名詞
ぶらっくれざーぱんつ	ブラックレザーパンツ	名詞
ぶらん	ブラン	名詞
ぶらんご	ブランゴ	名詞
ぶりげいど	ブリゲイド	名詞
ぶるっく	ブルック	名詞
ふるどれす	フルドレス	名詞
ぶるふぁんごふぇいく	ブルファンゴフェイク	名詞
ふるふる	フルフル	名詞
ぶれいぶ	ブレイブ	名詞
ふろがだ	フロガダ	名詞
ふろぎぃ	フロギィ	名詞
ぶろっさむ	ブロッサム	名詞
ぺっこ	ペッコ	名詞
べりお	ベリオ	名詞
へりおす	ヘリオス	名詞
せれね	セレネ	名詞
べるだー	ベルダー	名詞
へるぱー	ヘルパー	名詞
ぼうや	坊屋	名詞
ほーく	ホーク	名詞
えこーる	エコール	名詞
ほーぷ	ホープ	名詞
ぼーん	ボーン	名詞
ほくしん	ホクシン	名詞
かいえん	カイエン	名詞
ぽぼるむ	ポボルム	名詞
ぼろす	ボロス	名詞
ほろろ	ホロロ	名詞
まかるぱ	マカルパ	名詞
わざわいよろい	禍鎧	名詞
まぎゅる	マギュル	名詞
まぐしあ	マグシア	名詞
まはのぴあす	魔刃のピアス	名詞
まじん	魔刃	名詞
ますたー	マスター	名詞
まっかぉ	マッカォ	名詞
まどか	まどか	名詞
まふもふ	マフモフ	名詞
まむがいら	マムガイラ	名詞
まりねろ	マリネロ	名詞
みく	ミク	名詞
みつね	ミツネ	名詞
みづは	ミヅハ	名詞
とよたま	トヨタマ	名詞
みらあるま	ミラアルマ	名詞
みらばるかん	ミラバルカン	名詞
みらるーつ	ミラルーツ	名詞
むーふぁ	ムーファ	名詞
めいえんてんがい	冥淵纏鎧	名詞
めいど	メイド	名詞
めでゅれと	メデュレト	名詞
めるぜ	メルゼ	名詞
めるほあ	メルホア	名詞
もがぴすか	モガピスカ	名詞
もす	モス	名詞
ものでびる	モノデビル	名詞
ものぶろす	モノブロス	名詞
もんはんくろすいしょう	モンハンクロス衣装	名詞
もんはんぶじゃけっと	モンハン部ジャケット	名詞
もんはんぶじゃーじ	モンハン部ジャージ	名詞
もんはんぶせいふく	モンハン部制服	名詞
やしゃ	夜叉	名詞
しゅら	修羅	名詞
やつかだ	ヤツカダ	名詞
やまと	大和	名詞
ひなた	日向	名詞
ゆあみ	ユアミ	名詞
ゆうしゃ	勇者	名詞
ゆくもの	ユクモノ	名詞
ゆにくろ	ユニクロ	名詞
ゆぷけ	ユプケ	名詞
ゆらゆらふぇいく	ユラユラフェイク	名詞
よつみ	ヨツミ	名詞
らーす	ラース	名詞
らいだー	ライダー	名詞
らゔぁ	ラヴァ	名詞
らゔぃ	ラヴィ	名詞
らゔぃーな	ラヴィーナ	名詞
らぎあ	ラギア	名詞
らんぐろ	ラングロ	名詞
らんご	ランゴ	名詞
らんせ	ランセ	名詞
らんぽす	ランポス	名詞
りあん	リアン	名詞
りおそうる	リオソウル	名詞
りおでゅお	リオデュオ	名詞
りおはーと	リオハート	名詞
りのぷろ	リノプロ	名詞
りべりおん	リベリオン	名詞
らいおっと	ライオット	名詞
りもすふぇいく	リモスフェイク	名詞
りゅうおうのせきがん	竜王の隻眼	名詞
りゅうもん	龍紋	名詞
りゅうれきし	龍歴士	名詞
りょうだんいんのあかし	猟団員の証	名詞
りるす	リルス	名詞
るーきー	ルーキー	名詞
るこ	ルコ	名詞
るどろす	ルドロス	名詞
るながろ	ルナガロ	名詞
れある	レアル	名詞
れいあ	レイア	名詞
れいじ	レイジ	名詞
あなと	アナト	名詞
れうす	レウス	名詞
れぎおす	レギオス	名詞
れざー	レザー	名詞
れざーらいと	レザーライト	名詞
れっくす	レックス	名詞
ろーぜ	ローゼ	名詞
ろっくらっく	ロックラック	名詞
ろわーが	ロワーガ	名詞
ふぁるめる	ファルメル	名詞
てんらん	天嵐	名詞
はしゅ	覇種	名詞
れっしゅ	烈種	名詞
ししゅ	始種	名詞
せんゆう	遷悠	名詞
せんい	辿異	名詞
てんろう	天廊	名詞

##########
# 装飾品
えんりんだま	炎鱗珠	名詞
かえんだま	火炎珠	名詞
かえんだま	火炎珠Ⅳ	名詞
かすみがわだま	霞皮珠	名詞
かんしょうだま	緩衝珠	名詞
かんつうだま	貫通珠	名詞
かんつうだま	貫通珠Ⅱ	名詞
きゅうちだま	窮地珠	名詞
きゅうちだま	窮地珠Ⅱ	名詞
きょうおうだま	供応珠	名詞
きょうしょくだま	狂蝕珠	名詞
ぎゃくしゅうだま	逆襲珠	名詞
ぎゃくしゅうだま	逆襲珠Ⅱ	名詞
ぎゃくじょうだま	逆上珠	名詞
ぎゃくじょうだま	逆上珠Ⅱ	名詞
けっきだま	血氣珠	名詞
けんえいだま	研鋭珠	名詞
けんえいだま	研鋭珠Ⅱ	名詞
こうかくだま	鋼殻珠	名詞
こうげきだま	攻撃珠	名詞
こうげきだま	攻撃珠Ⅱ	名詞
こうせいだま	攻勢珠	名詞
こうせいだま	攻勢珠Ⅱ	名詞
こうちだま	巧緻珠	名詞
こうちだま	巧緻珠Ⅱ	名詞
こんしんだま	渾身珠	名詞
こんしんだま	渾身珠Ⅱ	名詞
ごうきだま	合気珠	名詞
ごうきだま	合気珠Ⅱ	名詞
ごうしんだま	剛心珠	名詞
ごうしんだま	剛心珠Ⅱ	名詞
ごうじんだま	剛刃珠	名詞
ごうじんだま	剛刃珠Ⅱ	名詞
ごうだんだま	強弾珠	名詞
ごうだんだま	強弾珠Ⅱ	名詞
さんだんだま	散弾珠	名詞
さんだんだま	散弾珠Ⅱ	名詞
ざんてつだま	斬鉄珠	名詞
ざんてつだま	斬鉄珠Ⅱ	名詞
しゅせいだま	守勢珠	名詞
しゅせいだま	守勢珠Ⅱ	名詞
じゅうげきだま	重撃珠	名詞
じゅうげきだま	重撃珠Ⅱ	名詞
じんりんだま	刃鱗珠	名詞
じんりんだま	刃鱗珠Ⅱ	名詞
すいみんだま	睡眠珠	名詞
すいみんだま	睡眠珠Ⅱ	名詞
せんえいだま	煽衛珠	名詞
せんえいだま	煽衛珠Ⅱ	名詞
ぜんかいだま	全開珠	名詞
ぜんかいだま	全開珠Ⅱ	名詞
そうてんだま	装填珠	名詞
そうてんだま	装填珠Ⅱ	名詞
そくのうだま	速納珠	名詞
そくのうだま	速納珠Ⅱ	名詞
そくへんへんだま	速変珠	名詞
そくへんへんだま	速変珠Ⅱ	名詞
そこぢからだま	底力珠	名詞
そこぢからだま	底力珠Ⅱ	名詞
ぞうだんだま	増弾珠	名詞
ぞうだんだま	増弾珠Ⅱ	名詞
ぞくげきだま	属撃珠	名詞
ぞくげきだま	属撃珠Ⅱ	名詞
たいどくだま	耐毒珠	名詞
たいどくだま	耐毒珠Ⅲ	名詞
たいばくだま	耐爆珠	名詞
たいばくだま	耐爆珠Ⅲ	名詞
たいまだま	耐麻珠	名詞
たいまだま	耐麻珠Ⅲ	名詞
たいみんだま	耐眠珠	名詞
たいみんだま	耐眠珠Ⅲ	名詞
たくみだま	匠珠	名詞
たくみだま	匠珠Ⅱ	名詞
たつげいだま	達芸珠	名詞
たつげいだま	達芸珠Ⅱ	名詞
たつじんだま	達人珠	名詞
たつじんだま	達人珠Ⅱ	名詞
ちょうせんだま	挑戦珠	名詞
ちょうせんだま	挑戦珠Ⅱ	名詞
てんしゃだま	点射珠	名詞
てんしゃだま	点射珠Ⅲ	名詞
てんぷくだま	転福珠	名詞
てんぷくだま	転福珠Ⅱ	名詞
とくしゃだま	特射珠	名詞
とくしゃだま	特射珠Ⅱ	名詞
どくだま	毒珠	名詞
どくだま	毒珠Ⅲ	名詞
はいげきだま	背撃珠	名詞
はいげきだま	背撃珠Ⅱ	名詞
はりゅうだま	破龍珠	名詞
はりゅうだま	破龍珠Ⅳ	名詞
はんこうだま	反攻珠	名詞
はんこうだま	反攻珠Ⅱ	名詞
ばくはだま	爆破珠	名詞
ばくはだま	爆破珠Ⅱ	名詞
ばんじゃくだま	盤石珠	名詞
ばんじゃくだま	盤石珠Ⅲ	名詞
ひょうけつだま	氷結珠	名詞
ひょうけつだま	氷結珠Ⅳ	名詞
ほうじゅつだま	砲術珠	名詞
ほうじゅつだま	砲術珠Ⅱ	名詞
ほんいだま	翻異珠	名詞
ほんいだま	翻異珠Ⅱ	名詞
まひだま	麻痺珠	名詞
まひだま	麻痺珠Ⅱ	名詞
むきずだま	無傷珠	名詞
むきずだま	無傷珠Ⅱ	名詞
らいこうだま	雷光珠	名詞
らいこうだま	雷光珠Ⅳ	名詞
りゅうきだま	龍気珠	名詞
りゅうすいだま	流水珠	名詞
りゅうすいだま	流水珠Ⅳ	名詞
りゅうふくだま	溜幅珠	名詞
りゅうふくだま	溜幅珠Ⅱ	名詞
れんげきだま	連撃珠	名詞
れんげきだま	連撃珠Ⅱ	名詞

##########
# 百竜装飾品
ひゃくりゅうそうしょくひん	百竜装飾品	名詞
えんこんりゅうだま	炎魂竜珠	名詞
えんこんりゅうだま	怨魂竜珠	名詞
おんこんりゅうだま	怨魂竜珠	名詞
かかくりゅうだま	火拡竜珠	名詞
かこんりゅうだま	霞魂竜珠	名詞
きげきりゅうだま	鬼激竜珠	名詞
きょくぞくりゅうだま	曲続竜珠	名詞
こうこんりゅうだま	鋼魂竜珠	名詞
こんちょうりゅうだま	魂鳥竜珠	名詞
ごうけつりゅうだま	劫血竜珠	名詞
ごけんりゅうだま	護研竜珠	名詞
ごじんりゅうだま	護刃竜珠	名詞
さいはいりゅうだま	采配竜珠	名詞
すいかくりゅうだま	水拡竜珠	名詞
ぞくつうりゅうだま	属痛竜珠	名詞
だいそうりゅうだま	大奏竜珠	名詞
つうこんりゅうだま	痛恨竜珠	名詞
てんこんりゅうだま	天魂竜珠	名詞
はくうりゅうだま	破空竜珠	名詞
はしょうりゅうだま	破小竜珠	名詞
はじゅうりゅうだま	破獣竜珠	名詞
はりゅうりゅうだま	破流竜珠	名詞
はりゅうりゅうだま	破竜竜珠	名詞
ひょうかくりゅうだま	氷拡竜珠	名詞
ふうじんりゅうだま	風神竜珠	名詞
へんげきりゅうだま	変撃竜珠	名詞
らいかくりゅうだま	雷拡竜珠	名詞
らいじんりゅうだま	雷神竜珠	名詞
りゅうこうりゅうだま	竜杭竜珠	名詞

# 百竜装飾品スキル
えんおうりゅうのたましい	炎王龍の魂	名詞
おともへのさいはい	オトモへの采配	名詞
おんこりゅうのたましい	怨虎竜の魂	名詞
かすみりゅうのたましい	霞龍の魂	名詞
かみなりやられとっこう	雷やられ特効	名詞
がじゅうしゅとっこう	牙獣種特効	名詞
きじんげきか	鬼人激化	名詞
きょくしゃこうかじぞく	曲射効果持続	名詞
くうせいけいとっこう	空棲系特効	名詞
こうりゅうのたましい	鋼龍の魂	名詞
こおりやられとっこう	氷やられ特効	名詞
こがたとっこう	小型特効	名詞
ごうけつかっせい	劫血活性	名詞
じゃくてんとっこうぞくせい	弱点特効【属性】	名詞
すいせいけいとっこう	水棲系特効	名詞
だいおんりょうえんそう	大音量演奏	名詞
つうこんのいちげき	痛恨の一撃	名詞
てんせいりゅうのたましい	天彗龍の魂	名詞
ひとだまとりばいか	人魂鳥倍加	名詞
ひやられとっこう	火やられ特効	名詞
びんへんけいきょうか	ビン変形強化	名詞
ふうじんりゅうのたましい	風神龍の魂	名詞
ぼうぎょけんまじゅつ	防御研磨術	名詞
みずやられとっこう	水やられ特効	名詞
らいじんりゅうのたましい	雷神龍の魂	名詞
りゅうこうほうきょうか	竜杭砲強化	名詞
りゅうしゅとっこう	竜種特効	名詞

