# Thx
# https://wikiwiki.jp/nenaiko/
# https://a-to-monhan.com/2020/12/28/rise-kannji-yomikata/

##########
# ゲーム内用語

# あ行

あいてむおとどけたい	アイテムお届け隊	名詞
あいてむぽーち	アイテムポーチ	名詞
あいてむぼっくす	アイテムボックス	名詞
あいるーきっちん	アイルーキッチン	名詞
あしゅ	亜種	名詞
いとこうそく	糸拘束	名詞
いとこうそくじょうたい	糸拘束状態	名詞
いのりのつぼ	イノリの壺	名詞
うさだんご	うさ団子	名詞
うたひめしゅえいせん	歌姫狩衛戦	名詞
おともんたんけんたい	オトモン探検隊	名詞
おにび	鬼火	名詞
おにびやられ	鬼火やられ	名詞
おまもり	護石	名詞
ごせき	護石	名詞
おんせんどりんく	温泉ドリンク	名詞

# か行

かいいか	傀異化	名詞
かいいちょうさくえすと	傀異調査クエスト	名詞
かいいれんせい	傀異錬成	名詞
かいかんたんくえすと	下位簡単クエスト	名詞
かいくえすと	下位クエスト	名詞
かいしんりつ	会心率	名詞
がいそうへんこう	外装変更	名詞
かいたくあそび	開拓遊び	名詞
かけりむし	翔蟲	名詞
かさねいろ	重音色	名詞
かさねぎそうび	重ね着装備	名詞
かみなりぞくせい	雷属性	名詞
かりうどさい	狩人祭	名詞
かりうどだま	狩人珠	名詞
がんなー	ガンナー	名詞
きーくえすと	キークエスト	名詞
きしゅ	奇種	名詞
きしょうしゅ	希少種	名詞
きずないでんし	絆遺伝子	名詞
きゅうじんく	求人区	名詞
きゅうなんしんごう	救難信号	名詞
きょうぼうこたい	凶暴個体	名詞
きょうりゅうしょう	狂竜症	名詞
きょうりゅうういるす	狂竜ウイルス	名詞
きょうりゅうういるすけんきゅうしょ	狂竜ウイルス研究所	名詞
きょくげんきょうか	極限強化	名詞
きょくげんせいばつせん	極限征伐戦	名詞
きりかたほせい	斬り方補正	名詞
きれあじ	斬れ味	名詞
ぐーくなべ	グーク鍋	名詞
くらっちくろー	クラッチクロー	名詞
げきこたい	激個体	名詞
げんしゅ	原種	名詞
こうげきりょくぶーすと	攻撃力ブースト	名詞
ごうけつやられ	劫血やられ	名詞
ごうしゅ	剛種	名詞
ごう・てん	剛・天	名詞
こうまくこたい	鋼膜個体	名詞
こおりぞくせい	氷属性	名詞

# さ行

しげんか	資源化	名詞
ししゅ	始種	名詞
しじる	シジル	名詞
してんせいばつせん	至天征伐戦	名詞
じゃくこたい	若個体	名詞
じゅうゆこうそくじょうたい	重油拘束状態	名詞
しゅきちょう	手記帳	名詞
しゅりょうせん	狩猟船	名詞
しゅれんどう	狩煉道	名詞
しょうきしんしょくじょうたい	瘴気侵蝕状態	名詞
じりょくやられ	磁力やられ	名詞
しるべむし	導蟲	名詞
すきるかふ	スキルカフ	名詞
せいちょうのこだいひ	成長の古代碑	名詞
ぜんせんりつこうかえんちょう	全旋律効果延長	名詞
せんゆうしゅ	遷悠種	名詞
そうぞくせい	双属性	名詞
そうりゅう	操竜	名詞
ぞくせいやられ	属性やられ	名詞

# た行

たーげっとかめら	ターゲットカメラ	名詞
だいれんぞくしゅりょうくえすと	大連続狩猟クエスト	名詞
たまきれ	弾切れ	名詞
ちょうえつひぎ	超越秘儀	名詞
てんいしゅ	辿異種	名詞
てんいすきる	辿異スキル	名詞
でんしょうのぎ	伝承の儀	名詞
てんろうろうえんせいろく	天廊遠征録	名詞
とくいこたい	特異個体	名詞
どっこうしゅ	独行種	名詞
とくしゅしゅ	特殊種	名詞

# な行

にとうくえすと	二頭クエスト	名詞
にゃんたー	ニャンター	名詞
にゃんたーくえすと	ニャンタークエスト	名詞
にゃんたーもーど	ニャンターモード	名詞
にゅうもんく	入門区	名詞
にんむくえすと	任務クエスト	名詞
ぬし	ヌシ	名詞
ねこすきる	ネコスキル	名詞

# は行

ばうんてぃ	バウンティ	名詞
はぎとり	剥ぎ取り	名詞
はしゅ	覇種	名詞
ヴぉるひーるぐんとう	ヴォルヒール群島	名詞
たぶらでぃんぐんとう	タブラディン群島	名詞
まらくじゃぐんとう	マラクジャ群島	名詞
ばとるらいん	バトルライン	名詞
ぱろーねだいこうさい	パローネ大航祭	名詞
ひゃくりゅうきょうか	百竜強化	名詞
ひゃくりゅうやこう	百竜夜行	名詞
ぷーぎーれーす	プーギーレース	名詞
ふぁすととらべる	ファストトラベル	名詞
ぶいはかい	部位破壊	名詞
ぶきないぞうだん	武器内蔵弾	名詞
ぶきばいりつ	武器倍率	名詞
ふくごうすきる	複合スキル	名詞
ふくぞくせい	複属性	名詞
ぶぐや	武具屋	名詞
ふしょくやられ	腐食やられ	名詞
ふたつなすきる	二つ名スキル	名詞
ふたつなそうび	二つ名装備	名詞
ふっきく	復帰区	名詞
ふらっとはんたー	ふらっとハンター	名詞
へいと	ヘイト	名詞
へんしゅ	変種	名詞

# ま行

まいがーでん	マイガーデン	名詞
まいせっと	マイセット	名詞
まいとれ	マイトレ	名詞
まかれんきん	マカ錬金	名詞
まかれんきんや	マカ錬金屋	名詞
みだしなみちけっと	身だしなみチケット	名詞
めいいさむくえすと	盟勇クエスト	名詞
めぜぽるたふぇすた	メゼポルタフェスタ	名詞
もーしょんち	モーション値	名詞
もんすたーらいど	モンスターライド	名詞
もんにゃんたい	モンニャン隊	名詞

# や行

ゆきだるまじょうたい	雪だるま状態	名詞
よろずやき	よろず焼き	名詞

# ら行

らいどあくしょん	ライドアクション	名詞
らいどおん	ライドオン	名詞
りぽっぷ	リポップ	名詞
りゅうき	龍気	名詞
りゅうじんとんや	竜人問屋	名詞
りゅうぞくせい	龍属性	名詞
りゅうほうりょく	龍封力	名詞
りょうだん	猟団	名詞
りょうちゅう	猟虫	名詞
るーむさーびす	ルームサービス	名詞
れつしゅ	烈種	名詞
れっしょう	裂傷	名詞
れっしょうじょうたい	裂傷状態	名詞
ねんき	練気	名詞
ねんきげーじ	練気ゲージ	名詞

# わ行

# 英数

EXそうび	EX装備	名詞
Gきゅうくえすと	G級クエスト	名詞
Gらんく	Gランク	名詞
Nぽいんと	Nポイント	名詞
じゅうれんよろずやき	10連よろず焼き	名詞

