# Thx
# https://wikiwiki.jp/nenaiko/
# https://a-to-monhan.com/2020/12/28/rise-kannji-yomikata/

##########
# アイテム xxのxx、xxしたxx 前半部分

#かいいか__傀異化__名詞
しょうじん	消尽	名詞
えんげん	淵源	名詞
ばくふ	瀑布	名詞
ぎょくずいか	玉髄化	名詞
しろたえ	白妙	名詞
そうこく	相克	名詞
はかい	破傀	名詞
こうか	硬化	名詞
せきえん	積怨	名詞
そうせい	蒼世	名詞
そうしょく	蒼色	名詞
はくひょうしょく	薄氷色	名詞
れっすい	裂水	名詞
かくかく	赫赫	名詞
きじん	鬼人	名詞

##########
# アイテム xxのxx、xxしたxx 後半部分

ゆめみこな	ゆめみ粉	名詞
#あぎと__アギト__名詞
#きも__キモ__名詞
#くちばし__クチバシ__名詞
#こいん__コイン__名詞
こーぱる	コーパル	名詞
じおーど	ジオード	名詞
#すたんぷ__スタンプ__名詞
#とさか__トサカ__名詞
#なみだ__ナミダ__名詞
ねじぱーつ	ネジパーツ	名詞
#ひげ__ヒゲ__名詞
#ふぇろもん__フェロモン__名詞
#ふん__フン__名詞
#ぽーち__ポーチ__名詞
みつまたお	三又尾	名詞
じょうひげ	上ヒゲ	名詞
じょうひれ	上ヒレ	名詞
じょうじんび	上刃尾	名詞
じょうきょく	上棘	名詞
じょうもう	上毛	名詞
じょうけがわ	上毛皮	名詞
じょうひ	上皮	名詞
じょうはざい	上端材	名詞
じょううりん	上羽鱗	名詞
じょうわんう	上腕羽	名詞
#じょうしつなたまご__上質な卵__名詞
じょうにしきひれ	上錦ヒレ	名詞
じょうりん	上鱗	名詞
うえうろこ	上鱗	名詞
じょうこくもう	上黒毛	名詞
じょうりゅうりん	上龍鱗	名詞
#なかおち__中落ち__名詞
#よこくじょう__予告状__名詞
#せんにんひげ__仙人髭__名詞
#たいえき__体液__名詞
#ゆうたいけん__優待券__名詞
こうこうよく	光虹翼	名詞
とかく	兜角	名詞
かんかく	冠角	名詞
せいび	凄尾	名詞
とうごうもう	凍剛毛	名詞
とうかく	凍殻	名詞
とうそう	凍爪	名詞
とうりん	凍鱗	名詞
きょうじょうりん	凶上鱗	名詞
きょうごうそう	凶剛爪	名詞
きょうごうよく	凶剛翼	名詞
きょうごうかく	凶剛角	名詞
きょうこうりん	凶厚鱗	名詞
きょうけんかく	凶堅殻	名詞
きょうけんこつ	凶堅骨	名詞
きょうせんそう	凶尖爪	名詞
きょうせんかく	凶尖角	名詞
きょうかく	凶殻	名詞
きょうじょうけつ	凶浄血	名詞
きょうのうけつ	凶濃血	名詞
きょうそう	凶爪	名詞
きょうが	凶牙	名詞
きょうよく	凶翼	名詞
きょうよくまく	凶翼膜	名詞
きょうけつ	凶血	名詞
きょうかく	凶角	名詞
きょうじゅうかく	凶重殻	名詞
きょうじゅうが	凶重牙	名詞
きょうじゅうこつ	凶重骨	名詞
きょうえいが	凶鋭牙	名詞
きょうこつ	凶骨	名詞
きょうりん	凶鱗	名詞
とうかく	刀殻	名詞
じんび	刃尾	名詞
じんよく	刃翼	名詞
ごうとかく	剛兜角	名詞
ごうとうそう	剛凍爪	名詞
ごうじんよく	剛刃翼	名詞
ごうし	剛嘴	名詞
ごうへきけん	剛壁拳	名詞
ごうらんかく	剛嵐角	名詞
ごうさんそう	剛惨爪	名詞
ごうけんそう	剛拳爪	名詞
ごうしゅそう	剛朱爪	名詞
ごうもう	剛毛	名詞
ごうもうひれ	剛毛ヒレ	名詞
ごうじょうそう	剛浄爪	名詞
ごうそう	剛爪	名詞
ごうよく	剛翼	名詞
ごうよくそう	剛翼爪	名詞
ごうかく	剛角	名詞
ごうしょっかく	剛触角	名詞
ごうこうそう	剛鉤爪	名詞
ごうじんはつ	剛靭髭	名詞
#たまご__卵__名詞
こうらんりん	厚嵐鱗	名詞
あつげ	厚毛	名詞
あつげがわ	厚毛皮	名詞
あつがわ	厚皮	名詞
こうひまく	厚皮膜	名詞
こうよくまく	厚翼膜	名詞
こうひまく	厚飛膜	名詞
こうりん	厚鱗	名詞
こうりゅうりん	厚龍鱗	名詞
のどぶくろ	喉袋	名詞
#くちばし__嘴__名詞
ごうせいちゅう	噛生虫	名詞
#じごくみみ__地獄耳__名詞
けんびこう	堅尾甲	名詞
けんかく	堅殻	名詞
けんこう	堅甲	名詞
けんりゅうこつ	堅竜骨	名詞
けんきょうかく	堅胸殻	名詞
けんわんこう	堅腕甲	名詞
けんふくこう	堅腹甲	名詞
けんときん	堅頭襟	名詞
けんこつ	堅骨	名詞
けんりゅうこつ	堅龍骨	名詞
だよくそう	堕翼爪	名詞
じぶんぷん	塵粉	名詞
へんいかく	変異角	名詞
#へんそうつーる__変装ツール__名詞
おおくちばし	大クチバシ	名詞
おおとさか	大トサカ	名詞
おおのどぶくろ	大喉袋	名詞
おおくちばし	大嘴	名詞
だいほうぎょく	大宝玉	名詞
#おおざら__大皿__名詞
だいふんじん	大粉塵	名詞
#おおつぶなみだ__大粒ナミダ__名詞
だいこうぎょく	大紅玉	名詞
おおみみ	大耳	名詞
だいはいせんこう	大背尖甲	名詞
だいじゃばらこう	大蛇腹甲	名詞
だいじゅうこつ	大重骨	名詞
おおあご	大顎	名詞
おおかざりばね	大飾り羽	名詞
だいびこつ	大鼻骨	名詞
てんかく	天殻	名詞
てんぎょく	天玉	名詞
てんりん	天鱗	名詞
ようとうかく	妖刀殻	名詞
ようわんじん	妖腕刃	名詞
ほうぎょく	宝玉	名詞
#み__実__名詞
しゅくぼうどう	宿望瞳	名詞
せんけんそう	尖拳爪	名詞
せんそう	尖爪	名詞
せんかく	尖角	名詞
せんこうそう	尖鉤爪	名詞
#しっぽ__尻尾__名詞
びきょく	尾棘	名詞
びこう	尾甲	名詞
しどくきょく	屍毒棘	名詞
らんぎょく	嵐玉	名詞
らんかく	嵐角	名詞
らんりん	嵐鱗	名詞
#す__巣__名詞
きょりゅうこつ	巨龍骨	名詞
たいでんもう	帯電毛	名詞
#えんずい__延髄__名詞
いんかえき	引火液	名詞
さいすいしょう	彩水晶	名詞
まどろみ	微睡み	名詞
どはつひれ	怒髪ヒレ	名詞
#どはつてん__怒髪天__名詞
けんそう	拳爪	名詞
げきそうよく	撃槍翼	名詞
ざんじんりん	斬刃鱗	名詞
ざんばね	斬羽	名詞
ざんよくそう	斬翼爪	名詞
だんとうかく	断刀角	名詞
せんび	旋尾	名詞
こんこうび	昏鉤尾	名詞
あんこくよく	暗黒翼	名詞
ぼうふうぶくろ	暴風袋	名詞
#さいじょうきゅうたまご__最上級卵__名詞
じゅうひ	柔皮	名詞
#とげ__棘__名詞
ごくじょうなたまご	極上な卵	名詞
きょくしょうかく	極小殻	名詞
そうじんび	槍刃尾	名詞
そうよく	槍翼	名詞
#かけら__欠片__名詞
#け__毛__名詞
けひれ	毛ヒレ	名詞
#けだま__毛玉__名詞
#けがわ__毛皮__名詞
#すいしょう__水晶__名詞
#みずたま__水玉__名詞
ひょうそう	氷爪	名詞
#はどう__波動__名詞
でいど	泥土	名詞
じょうのうち	浄濃血	名詞
じょうけつ	浄血	名詞
じょうりゅうち	浄龍血	名詞
#なみだ__涙__名詞
ようがんでいど	溶岩泥土	名詞
かつえき	滑液	名詞
のうどくけつ	濃毒血	名詞
のうじゅう	濃汁	名詞
のうじゅうさん	濃重酸	名詞
のうりゅうけつ	濃龍血	名詞
とうふく	灯腹	名詞
こうもう	煌毛	名詞
こうえき	煌液	名詞
ゆうしょう	熊掌	名詞
ばくせん	爆腺	名詞
ばくせんそく	爆腺束	名詞
らんとうふく	爛灯腹	名詞
#つめ__爪__名詞
#きば__牙__名詞
とくじょうひれ	特上ヒレ	名詞
とくじょうがわ	特上皮	名詞
とくじょうざら	特上皿	名詞
とくじょうはね	特上羽	名詞
とくじょううりん	特上羽鱗	名詞
とくじょうあたま	特上頭	名詞
とくだいのどぶくろ	特大喉袋	名詞
とくだいかざりばね	特大飾り羽	名詞
とくのう	特濃	名詞
とくにしきひれ	特錦ヒレ	名詞
もうしょくしゅ	猛触手	名詞
ごくとかく	獄兜角	名詞
ごくとうかく	獄刀殻	名詞
こうかく	甲殻	名詞
#いこくせいず__異国製図__名詞
はっかえき	発火液	名詞
はくごうもう	白剛毛	名詞
はくじんび	白靭尾	名詞
#かわ__皮__名詞
#ひまく__皮膜__名詞
#さら__皿__名詞
#ねむりこな__眠り粉__名詞
げんとうふく	眩灯腹	名詞
とじんび	砥刃尾	名詞
はかいぎょく	破傀玉	名詞
はじん	破刃	名詞
#はへん__破片__名詞
へききょく	碧棘	名詞
へきぎょく	碧玉	名詞
へきじゅうきょく	碧重棘	名詞
まがだま	禍玉	名詞
かりん	禍鱗	名詞
ひきょく	秘棘	名詞
ひひょうぎょく	秘氷玉	名詞
#ひやく__秘薬__名詞
きっか	稀花	名詞
きはな	稀花	名詞
まれはな	稀花	名詞
#たね__種__名詞
せんえんそう	穿淵爪	名詞
りゅうだいこつ	竜大骨	名詞
りゅうとうこつ	竜頭骨	名詞
りゅうこつ	竜骨	名詞
りゅうこつかい	竜骨塊	名詞
りゅうこっぺん	竜骨片	名詞
りゅうこつへん	竜骨片	名詞
りゅうりん	竜鱗	名詞
#はざい__端材__名詞
#ふんじん__粉塵__名詞
ねんでいど	粘泥土	名詞
#いと__糸__名詞
こうし	紅嘴	名詞
べにはし	紅嘴	名詞
こうぎょく	紅玉	名詞
こうけつぎょく	紅血玉	名詞
じゅんねんでいど	純粘泥土	名詞
しじょうもう	紫上毛	名詞
しごうもう	紫剛毛	名詞
しもう	紫毛	名詞
しぎょく	紫玉	名詞
しじんび	紫靭尾	名詞
#けっしょう__結晶__名詞
ぜつそうび	絶槍尾	名詞
#きぬいと__絹糸__名詞
#はね__羽__名詞
#はね__羽根__名詞
うりん	羽鱗	名詞
#つばさ__翼__名詞
よくそう	翼爪	名詞
よくまく	翼膜	名詞
#みみ__耳__名詞
はいせんこう	背尖甲	名詞
はいごんかく	背巌殻	名詞
はいこう	背甲	名詞
きょうかく	胸殻	名詞
わんじん	腕刃	名詞
わんこう	腕甲	名詞
わんう	腕羽	名詞
ふくこう	腹甲	名詞
はらぶくろ	腹袋	名詞
つやかわ	艶皮	名詞
つやいと	艶糸	名詞
つやきぬいと	艶絹糸	名詞
#はな__花__名詞
たいけんこう	苔堅甲	名詞
たいはいこう	苔背甲	名詞
たいじゅうこう	苔重甲	名詞
あらかみひれ	荒髪ヒレ	名詞
はなとさか	華鶏冠	名詞
#は__葉__名詞
ちくでんかく	蓄電殻	名詞
#ふた__蓋__名詞
じゃばらこう	蛇腹甲	名詞
#ち__血__名詞
はわんじん	覇腕刃	名詞
#つの__角__名詞
#しょくしゅ__触手__名詞
#ちょうどひん__調度品__名詞
#ごふ__護符__名詞
ごうごうもう	豪剛毛	名詞
ごうはんもう	豪斑毛	名詞
ごうそうじんび	豪槍刃尾	名詞
ごうもうひれ	豪毛ヒレ	名詞
ごうわんう	豪腕羽	名詞
ごうこくもう	豪黒毛	名詞
かくじょうはざい	赫上端材	名詞
かくしゃくかく	赫灼殻	名詞
かくこうかく	赫煌殻	名詞
かくじゅうはざい	赫重端材	名詞
ちょうでんかく	超電殻	名詞
ちょうでんまく	超電膜	名詞
ごうえんぶくろ	轟炎袋	名詞
げきりん	逆鱗	名詞
とうじんよく	透刃翼	名詞
じゃかく	邪角	名詞
じゅうかんこう	重冠甲	名詞
じゅうどこつ	重土骨	名詞
じゅうび	重尾	名詞
じゅうびきょく	重尾棘	名詞
じゅうびこう	重尾甲	名詞
じゅうきょく	重棘	名詞
じゅうきょくかく	重棘殻	名詞
じゅうかく	重殻	名詞
じゅうが	重牙	名詞
じゅうこう	重甲	名詞
じゅうりゅうこつ	重竜骨	名詞
じゅうはざい	重端材	名詞
じゅうきょうかく	重胸殻	名詞
じゅうきゃく	重脚	名詞
じゅうわんこう	重腕甲	名詞
じゅうふくこう	重腹甲	名詞
じゅうかく	重角	名詞
じゅうこうきょく	重鉤棘	名詞
じゅうしゅうび	重鍬尾	名詞
じゅうとうかく	重頭殻	名詞
じゅうときん	重頭襟	名詞
じゅうこつ	重骨	名詞
じゅうびこつ	重鼻骨	名詞
じゅうりゅうこつ	重龍骨	名詞
こんごうかく	金剛角	名詞
#きんか__金貨__名詞
こうきょく	鉤棘	名詞
かぎづめ	鉤爪	名詞
#こうせき__鉱石__名詞
きょうじんび	鋏刃尾	名詞
えいじんよく	鋭刃翼	名詞
えいそう	鋭爪	名詞
えいが	鋭牙	名詞
えいよくそう	鋭翼爪	名詞
はがねひげ	鋼ヒゲ	名詞
にしきひれ	錦ヒレ	名詞
#よろい__鎧__名詞
がいじゅうかく	鎧重殻	名詞
きょうぎょく	鏡玉	名詞
ちょうぜん	長髭	名詞
せんれつそう	閃裂爪	名詞
えんけっしょう	閻結晶	名詞
れいぎょく	零玉	名詞
らいこうしん	雷光針	名詞
らいきょくしん	雷極針	名詞
かみなりぶくろ	雷袋	名詞
らいでんかく	雷電殻	名詞
らいでんもう	雷電毛	名詞
らいでんぶくろ	雷電袋	名詞
ひょうそうかく	雹蒼核	名詞
でんきょくばり	電極針	名詞
れいけっしょう	霊結晶	名詞
#しもふり__霜降り__名詞
じんび	靭尾	名詞
じんびかく	靭尾殻	名詞
じんそうじんび	靭槍刃尾	名詞
べんび	鞭尾	名詞
#あたま__頭__名詞
とうかく	頭殻	名詞
ときん	頭襟	名詞
かぜぶくろ	風袋	名詞
かざりばね	飾り羽	名詞
#ほね__骨__名詞
#こつずい__骨髄__名詞
こうでんかく	高電殻	名詞
こうでんもう	高電毛	名詞
かみひれ	髪ヒレ	名詞
#ひげ__髭__名詞
こんけっしょう	魂結晶	名詞
こんぱくけっしょう	魂魄結晶	名詞
#うろこ__鱗__名詞
れいか	麗花	名詞
#まひばり__麻痺針__名詞
おうぎょく	黄玉	名詞
#くろげ__黒毛__名詞
こくこうし	黒紅糸	名詞
こくこうもう	黒荒毛	名詞
びこつ	鼻骨	名詞
りゅうぎょく	龍玉	名詞
りゅうじんぎょく	龍神玉	名詞
りゅうひほう	龍秘宝	名詞
りゅうけつ	龍血	名詞
りゅうこつ	龍骨	名詞
りゅうりん	龍鱗	名詞

##########
# アイテム
# あ行
あいけんのねじぱーつ	愛犬のネジパーツ	名詞
あいしすめたる	アイシスメタル	名詞
あおいろのたね	蒼色の種	名詞
あおきのこ	アオキノコ	名詞
あかきんぎょ	赤金魚	名詞
あかしらぬいか	赤シラヌイカ	名詞
#あきびん__空きビン
あきんどんぐり	アキンドングリ	名詞
あたたかいけがわ	暖かい毛皮	名詞
あみきりあかね	アミキリアカネ	名詞
あめいろのこーぱる	飴色のコーパル	名詞
あめふりつぶり	アメフリツブリ	名詞
あやしげなえいが	怪しげな鋭牙	名詞
あやしげなきば	怪しげな牙	名詞
あやしげなじゅうが	怪しげな重牙	名詞
あるてぃまけっしょう	アルティマ結晶	名詞
あるびのえきす	アルビノエキス	名詞
あるびののしもふり	アルビノの霜降り	名詞
あるびののなかおち	アルビノの中落ち	名詞
あわだつかつえき	泡立つ滑液	名詞
あわだつじょうかつえき	泡立つ上滑液	名詞
あわだつのうかつえき	泡立つ濃滑液	名詞
あんごしっくらげ	アンゴシックラゲ	名詞
あんもさかがい	アンモサカガイ	名詞
いかしたとさか	イカしたトサカ	名詞
いかだがき	イカダガキ	名詞
いこくのきんか	異国の金貨	名詞
いしもりとかげ	イシモリトカゲ	名詞
いずちのけ	イズチの毛	名詞
いずちのごうごうもう	イズチの豪剛毛	名詞
いずちのごうもう	イズチの剛毛	名詞
いずちのじんび	イズチの刃尾	名詞
いだいなくちばし	偉大なクチバシ	名詞
いだいなとさか	偉大なトサカ	名詞
いちもくらぶ	イチモクラブ	名詞
いったんもんしろ	イッタンモンシロ	名詞
いっぴんきのこ	逸品キノコ	名詞
いっぴんたけのこ	逸品タケノコ	名詞
いつつぼしつぼかずら	五ツ星ツボカズラ	名詞
いてついたじゅうひょうこつ	凍てついた重氷骨	名詞
いてつくろうじゅうが	凍てつく狼重牙	名詞
いにしえのきょりゅうこつ	いにしえの巨龍骨	名詞
いにしえのきんか	いにしえの金貨	名詞
いにしえのひやく	いにしえの秘薬	名詞
いにしえのりゅうこつ	いにしえの龍骨	名詞
いにしえのりゅうひほう	いにしえの龍秘宝	名詞
いばらりゅうのこうりん	棘竜の厚鱗	名詞
いばらりゅうのごうかく	棘竜の剛角	名詞
いばらりゅうのじゅうかく	棘竜の重殻	名詞
いばらりゅうのじゅうはざい	棘竜の重端材	名詞
いばらりゅうのじんび	棘竜の靭尾	名詞
いばらりゅうのてんりん	棘竜の天鱗	名詞
いばらりゅうののうどくけつ	棘竜の濃毒血	名詞
いばらりゅうのひきょく	棘竜の秘棘	名詞
いわおもりとかげ	イワオモリトカゲ	名詞
うがつきょだいくちばし	穿つ巨大クチバシ	名詞
うさみみちけっと	うさみみチケット	名詞
うちけしのみ	ウチケシの実	名詞
うみうしぼうず	ウミウシボウズ	名詞
うもれたこつがい	埋もれた骨骸	名詞
うもれたこりゅうこつがい	埋もれた古龍骨骸	名詞
うもれたりゅうこつがい	埋もれた竜骨骸	名詞
うるおったさいすいしょう	潤った彩水晶	名詞
うろこもりとかげ	ウロコモリトカゲ	名詞
えいゆうおうのこいん	英雄王のコイン	名詞
えいりなきば	鋭利な牙	名詞
えいりなそう	鋭利な爪	名詞
えすぴなこいん	エスピナコイン	名詞
えるがどちけっと	エルガドチケット	名詞
えるとらいと	エルトライト	名詞
えるとらいとこうせき	エルトライト鉱石	名詞
えんえんく	エンエンク	名詞
えんおうりゅうのけんかく	炎王龍の堅殻	名詞
えんおうりゅうのごうかく	炎王龍の剛角	名詞
えんおうりゅうのしっぽ	炎王龍の尻尾	名詞
えんおうりゅうのじゅうかく	炎王龍の重殻	名詞
えんおうりゅうのじゅうはざい	炎王龍の重端材	名詞
えんおうりゅうのじょうはざい	炎王龍の上端材	名詞
えんおうりゅうのじんび	炎王龍の靭尾	名詞
えんおうりゅうのせんかく	炎王龍の尖角	名詞
えんおうりゅうのたてがみ	炎王龍のたてがみ	名詞
えんおうりゅうのはかいぎょく	炎王龍の破傀玉	名詞
えんげんのこうらんりん	淵源の厚嵐鱗	名詞
えんげんのごうらんかく	淵源の剛嵐角	名詞
えんげんのてんりん	淵源の天鱗	名詞
えんげんのらんかく	淵源の嵐角	名詞
えんげんのらんぎょく	淵源の嵐玉	名詞
えんげんのらんりん	淵源の嵐鱗	名詞
えんこんまといしせきとかく	怨恨纏いし隻兜角	名詞
えんさうめくがいとうかく	怨嗟呻く鎧刀殻	名詞
えんさきょうめくじゅうはざい	怨嗟響めく重端材	名詞
えんねつのようがんでいど	炎熱の溶岩泥土	名詞
えんりゅうのごうそう	炎龍の剛爪	名詞
えんりゅうのごうよく	炎龍の剛翼	名詞
えんりゅうのじんぷん	炎龍の塵粉	名詞
えんりゅうのせんそう	炎龍の尖爪	名詞
えんりゅうのつばさ	炎龍の翼	名詞
えんりゅうのほうぎょく	炎龍の宝玉	名詞
おうがいぎょく	王鎧玉	名詞
おうきゅうくすり	応急薬	名詞
おうきゅうくすりぐれーと	応急薬グレート	名詞
おうけのきんか	王家の金貨	名詞
おうこくきしだんのあかし	王国騎士団の証	名詞
おうこくきしだんのあかしいち	王国騎士団の証Ⅰ	名詞
おうこくきしだんのあかしさん	王国騎士団の証Ⅲ	名詞
おうこくきしだんのあかしに	王国騎士団の証Ⅱ	名詞
おうこのちょうどひん	往古の調度品	名詞
おうごんぎょ	黄金魚	名詞
おうごんのけ	黄金の毛	名詞
おうごんのこうもう	黄金の煌毛	名詞
おうごんれいてんとう	黄金霊テントウ	名詞
おうさまさぼてん	王様サボテン	名詞
おうじゃのくちばし	王者のクチバシ	名詞
おうじゃのとさか	王者のトサカ	名詞
おうどうのいこくせいず	王道の異国製図	名詞
おうにしきうお	王錦魚	名詞
おおきなこうこつ	大きな硬骨	名詞
おおきなひれ	大きなヒレ	名詞
おおきなほね	大きな骨	名詞
おおくわあげは	オオクワアゲハ	名詞
おおぐいまぐろ	大食いマグロ	名詞
おおたる	大タル	名詞
おおたるばくだん	大タル爆弾	名詞
おおたるばくだんじー	大タル爆弾G	名詞
おおだまさぼてん	大玉サボテン	名詞
おおどくくもり	オオ毒クモリ	名詞
おおみずぶくろ	大水袋	名詞
おおゆきおにきも	大雪鬼胆	名詞
おおよろいしだい	オオヨロイシダイ	名詞
おとしあな	落とし穴	名詞
おとばくだん	音爆弾	名詞
おともちけっと	オトモチケット	名詞
おともりんぐ	オトモリング	名詞
おぼろつきのかけら	朧月の欠片	名詞
おるぎぃのあつがわ	オルギィの厚皮	名詞
おるぎぃのこうりん	オルギィの厚鱗	名詞
おんこりゅうのうろこ	怨虎竜の鱗	名詞
おんこりゅうのえんけっしょう	怨虎竜の閻結晶	名詞
おんこりゅうのけんかく	怨虎竜の堅殻	名詞
おんこりゅうのげきりん	怨虎竜の逆鱗	名詞
おんこりゅうのこうかく	怨虎竜の甲殻	名詞
おんこりゅうのこうりん	怨虎竜の厚鱗	名詞
おんこりゅうのこんけっしょう	怨虎竜の魂結晶	名詞
おんこりゅうのこんぱくけっしょう	怨虎竜の魂魄結晶	名詞
おんこりゅうのごうそうじんび	怨虎竜の豪槍刃尾	名詞
おんこりゅうのごうとかく	怨虎竜の剛兜角	名詞
おんこりゅうのごくとうかく	怨虎竜の獄刀殻	名詞
おんこりゅうのごくとかく	怨虎竜の獄兜角	名詞
おんこりゅうのしぎょく	怨虎竜の紫玉	名詞
おんこりゅうのしゅくぼうぼう	怨虎竜の宿望瞳	名詞
おんこりゅうのじゅうかく	怨虎竜の重殻	名詞
おんこりゅうのじゅうはざい	怨虎竜の重端材	名詞
おんこりゅうのじょうはざい	怨虎竜の上端材	名詞
おんこりゅうのじょうりん	怨虎竜の上鱗	名詞
おんこりゅうのじんそうじんび	怨虎竜の靭槍刃尾	名詞
おんこりゅうのそうじんび	怨虎竜の槍刃尾	名詞
おんこりゅうのとうかく	怨虎竜の刀殻	名詞
おんこりゅうのとかく	怨虎竜の兜角	名詞
おんこりゅうのはざい	怨虎竜の端材	名詞
おんこりゅうのはわんじん	怨虎竜の覇腕刃	名詞
おんこりゅうのまがだま	怨虎竜の禍玉	名詞
おんこりゅうのようとうかく	怨虎竜の妖刀殻	名詞
おんこりゅうのようわんじん	怨虎竜の妖腕刃	名詞
おんこりゅうのよろいじゅうかく	怨虎竜の鎧重殻	名詞
おんこりゅうのれいけっしょう	怨虎竜の霊結晶	名詞
おんこりゅうのわんじん	怨虎竜の腕刃	名詞
# か行
かいいかしたあつがわ	傀異化した厚皮	名詞
かいいかしたうろこ	傀異化した鱗	名詞
かいいかしたえいが	傀異化した鋭牙	名詞
かいいかしたかわ	傀異化した皮	名詞
かいいかしたきば	傀異化した牙	名詞
かいいかしたきょうえいが	傀異化した凶鋭牙	名詞
かいいかしたきょうかく	傀異化した凶殻	名詞
かいいかしたきょうかく	傀異化した凶角	名詞
かいいかしたきょうきば	傀異化した凶牙	名詞
かいいかしたきょうけつ	傀異化した凶血	名詞
かいいかしたきょうけんかく	傀異化した凶堅殻	名詞
かいいかしたきょうけんこつ	傀異化した凶堅骨	名詞
かいいかしたきょうこうりん	傀異化した凶厚鱗	名詞
かいいかしたきょうこつ	傀異化した凶骨	名詞
かいいかしたきょうごうかく	傀異化した凶剛角	名詞
かいいかしたきょうごうそう	傀異化した凶剛爪	名詞
かいいかしたきょうごうよく	傀異化した凶剛翼	名詞
かいいかしたきょうじゅうかく	傀異化した凶重殻	名詞
かいいかしたきょうじゅうが	傀異化した凶重牙	名詞
かいいかしたきょうじゅうこつ	傀異化した凶重骨	名詞
かいいかしたきょうじょうけつ	傀異化した凶浄血	名詞
かいいかしたきょうじょうりん	傀異化した凶上鱗	名詞
かいいかしたきょうせんかく	傀異化した凶尖角	名詞
かいいかしたきょうせんそう	傀異化した凶尖爪	名詞
かいいかしたきょうそう	傀異化した凶爪	名詞
かいいかしたきょうのうけつ	傀異化した凶濃血	名詞
かいいかしたきょうよく	傀異化した凶翼	名詞
かいいかしたきょうよくまく	傀異化した凶翼膜	名詞
かいいかしたきょうりん	傀異化した凶鱗	名詞
かいいかしたけんかく	傀異化した堅殻	名詞
かいいかしたけんこつ	傀異化した堅骨	名詞
かいいかしたけんりゅうこつ	傀異化した堅竜骨	名詞
かいいかしたこうかく	傀異化した甲殻	名詞
かいいかしたこうりん	傀異化した厚鱗	名詞
かいいかしたごうそう	傀異化した剛爪	名詞
かいいかしたじゅうかく	傀異化した重殻	名詞
かいいかしたじゅうが	傀異化した重牙	名詞
かいいかしたじゅうこつ	傀異化した重骨	名詞
かいいかしたじゅうりゅうこつ	傀異化した重竜骨	名詞
かいいかしたじょうけつ	傀異化した浄血	名詞
かいいかしたじょうのうけつ	傀異化した浄濃血	名詞
かいいかしたじょうひ	傀異化した上皮	名詞
かいいかしたじょうりん	傀異化した上鱗	名詞
かいいかしたせんそう	傀異化した尖爪	名詞
かいいかしたそう	傀異化した爪	名詞
かいいかしたち	傀異化した血	名詞
かいいかしたほね	傀異化した骨	名詞
かいいかしたりゅうこつ	傀異化した竜骨	名詞
かいいげんしゅ	傀異原珠	名詞
かいいちょうさちけっと	傀異調査チケット	名詞
かいかちけっと	開花チケット	名詞
かいとうのよこくじょう	怪盗の予告状	名詞
かいふくだん	回復弾	名詞
かいふくみつむし	回復ミツムシ	名詞
かいふくやく	回復薬	名詞
かいふくやくぐれーと	回復薬グレート	名詞
かいめんしつのあつがわ	海綿質の厚皮	名詞
かいめんしつのかわ	海綿質の皮	名詞
かいめんしつのじょうひ	海綿質の上皮	名詞
かいりきのたね	怪力の種	名詞
かえんたるばくだん	火炎タル爆弾	名詞
かえんだん	火炎弾	名詞
かえんぶくろ	火炎袋	名詞
かがやくしりこだま	輝く尻子玉	名詞
かくかくのげきそうよく	赫赫の撃槍翼	名詞
かくかくのそうよく	赫赫の槍翼	名詞
かくされしきんか	隠されし金貨	名詞
かくさんだん	拡散弾	名詞
かくさんでめきん	カクサンデメキン	名詞
かくさんのみ	カクサンの実	名詞
かくせいまねくりゅうきたま	赫星招く龍氣玉	名詞
かくせいまねくりゅうじんだま	赫星招く龍神玉	名詞
かくゆれるこうりゅうりん	赫揺れる厚龍鱗	名詞
かくゆれるりゅうりん	赫揺れる龍鱗	名詞
かくりゅうのえんずい	角竜の延髄	名詞
かくりゅうのきば	角竜の牙	名詞
かくりゅうのけんかく	角竜の堅殻	名詞
かくりゅうのけんこう	角竜の堅甲	名詞
かくりゅうのこうかく	角竜の甲殻	名詞
かくりゅうのこつずい	角竜の骨髄	名詞
かくりゅうのじゅうかく	角竜の重殻	名詞
かくりゅうのじゅうこう	角竜の重甲	名詞
かくりゅうのじゅうはざい	角竜の重端材	名詞
かくりゅうのじゅうびこう	角竜の重尾甲	名詞
かくりゅうのじょうはざい	角竜の上端材	名詞
かくりゅうのはいこう	角竜の背甲	名詞
かくりゅうのはざい	角竜の端材	名詞
かくりゅうのびこう	角竜の尾甲	名詞
かけたりゅうこつ	欠けた龍骨	名詞
かけりむし	翔蟲	名詞
かこうあとのあるりゅうこつ	加工跡のある竜骨	名詞
かじきまぐろ	カジキマグロ	名詞
かすみりゅうのごうかく	霞龍の剛角	名詞
かすみりゅうのごうそう	霞龍の剛爪	名詞
かすみりゅうのごうよく	霞龍の剛翼	名詞
かすみりゅうのしっぽ	霞龍の尻尾	名詞
かすみりゅうのじゅうはざい	霞龍の重端材	名詞
かすみりゅうのじょうはざい	霞龍の上端材	名詞
かすみりゅうのじょうひ	霞龍の上皮	名詞
かすみりゅうのじんび	霞龍の靭尾	名詞
かすみりゅうのせんかく	霞龍の尖角	名詞
かすみりゅうのせんそう	霞龍の尖爪	名詞
かすみりゅうのつばさ	霞龍の翼	名詞
かすみりゅうのとくじょうかわ	霞龍の特上皮	名詞
かすみりゅうのはかいぎょく	霞龍の破傀玉	名詞
かすみりゅうのほうぎょく	霞龍の宝玉	名詞
かっぱかえるのあつがわ	河童蛙の厚皮	名詞
かっぱかえるのおおくちばし	河童蛙の大嘴	名詞
かっぱかえるのおおざら	河童蛙の大皿	名詞
かっぱかえるのかわ	河童蛙の皮	名詞
かっぱかえるのくちばし	河童蛙の嘴	名詞
かっぱかえるのごうし	河童蛙の剛嘴	名詞
かっぱかえるのさら	河童蛙の皿	名詞
かっぱかえるのじゅうはざい	河童蛙の重端材	名詞
かっぱかえるのじょうはざい	河童蛙の上端材	名詞
かっぱかえるのじょうひ	河童蛙の上皮	名詞
かっぱかえるのたいけんこう	河童蛙の苔堅甲	名詞
かっぱかえるのたいじゅうこう	河童蛙の苔重甲	名詞
かっぱかえるのたいはいこう	河童蛙の苔背甲	名詞
かっぱかえるのとくじょうざら	河童蛙の特上皿	名詞
かっぱかえるのはざい	河童蛙の端材	名詞
かつりょくざい	活力剤	名詞
かぶれらいと	カブレライト	名詞
かぶれらいとこうせき	カブレライト鉱石	名詞
かまがにのきょくしょうかく	鎌蟹の極小殻	名詞
かまがにのごうそう	鎌蟹の剛爪	名詞
かまがにのじゅうかく	鎌蟹の重殻	名詞
かまがにのじゅうはざい	鎌蟹の重端材	名詞
かまがにのじょうきゃく	鎌蟹の重脚	名詞
かみなりけころがし	雷毛コロガシ	名詞
かむらちけっと	カムラチケット	名詞
かもしわらし	カモシワラシ	名詞
かやくそう	火薬草	名詞
からのみ	カラの実	名詞
かりともちけっと	狩友チケット	名詞
かりゅうのうろこ	火竜の鱗	名詞
かりゅうのえいよくそう	火竜の鋭翼爪	名詞
かりゅうのえんずい	火竜の延髄	名詞
かりゅうのけんかく	火竜の堅殻	名詞
かりゅうのげきりん	火竜の逆鱗	名詞
かりゅうのこうえき	火竜の煌液	名詞
かりゅうのこうかく	火竜の甲殻	名詞
かりゅうのこうぎょく	火竜の紅玉	名詞
かりゅうのこうりん	火竜の厚鱗	名詞
かりゅうのこつずい	火竜の骨髄	名詞
かりゅうのごうよく	火竜の剛翼	名詞
かりゅうのごうよくそう	火竜の剛翼爪	名詞
かりゅうのしっぽ	火竜の尻尾	名詞
かりゅうのじゅうかく	火竜の重殻	名詞
かりゅうのじゅうはざい	火竜の重端材	名詞
かりゅうのじょうはざい	火竜の上端材	名詞
かりゅうのじょうりん	火竜の上鱗	名詞
かりゅうのじんび	火竜の靭尾	名詞
かりゅうのつばさ	火竜の翼	名詞
かりゅうのてんりん	火竜の天鱗	名詞
かりゅうのはざい	火竜の端材	名詞
かりゅうのよくそう	火竜の翼爪	名詞
かりゅうのよくまく	火竜の翼膜	名詞
かんしゃちけっと	感謝チケット	名詞
かんたろすのあたま	カンタロスの頭	名詞
かんたろすのざんばね	カンタロスの斬羽	名詞
かんたろすのじゅうかく	カンタロスの重殻	名詞
かんつうかえんだん	貫通火炎弾	名詞
かんつうすいれいだん	貫通水冷弾	名詞
かんつうだん	貫通弾	名詞
かんつうでんげきだん	貫通電撃弾	名詞
かんつうひょうけつだん	貫通氷結弾	名詞
かんつうめつりゅうだん	貫通滅龍弾	名詞
かんぽうのふんじん	漢方の粉塵	名詞
かんぽうやく	漢方薬	名詞
がいあろーず	ガイアローズ	名詞
がうしかのじゅうかく	ガウシカの重角	名詞
がうしかのつの	ガウシカの角	名詞
がじゅうのおおつぶなみだ	牙獣の大粒ナミダ	名詞
がじゅうのなみだ	牙獣のナミダ	名詞
がるめんぐちけっと	ガル面具チケット	名詞
がんじょうなほね	頑丈な骨	名詞
がんりゅうのきょうかく	岩竜の胸殻	名詞
がんりゅうのけんかく	岩竜の堅殻	名詞
がんりゅうのけんきょうかく	岩竜の堅胸殻	名詞
がんりゅうのこうかく	岩竜の甲殻	名詞
がんりゅうのごうよく	岩竜の剛翼	名詞
がんりゅうのしっぽ	岩竜の尻尾	名詞
がんりゅうのじゅうかく	岩竜の重殻	名詞
がんりゅうのじゅうきょうかく	岩竜の重胸殻	名詞
がんりゅうのじゅうはざい	岩竜の重端材	名詞
がんりゅうのじょうはざい	岩竜の上端材	名詞
がんりゅうのじんび	岩竜の靭尾	名詞
がんりゅうのつばさ	岩竜の翼	名詞
がんりゅうのてんかく	岩竜の天殻	名詞
がんりゅうのなみだ	岩竜の涙	名詞
がんりゅうのはざい	岩竜の端材	名詞
がーぐぁのきんのたまご	ガーグァの金の卵	名詞
がーぐぁのたまご	ガーグァの卵	名詞
がーぐぁのふん	ガーグァのフン	名詞
きがにあ	キガニア	名詞
きさきくものえいそう	妃蜘蛛の鋭爪	名詞
きさきくものきぬいと	妃蜘蛛の絹糸	名詞
きさきくものけんかく	妃蜘蛛の堅殻	名詞
きさきくものこうきょく	妃蜘蛛の鉤棘	名詞
きさきくものごうそう	妃蜘蛛の剛爪	名詞
きさきくものじゅうかく	妃蜘蛛の重殻	名詞
きさきくものじゅうこうきょく	妃蜘蛛の重鉤棘	名詞
きさきくものじゅうはざい	妃蜘蛛の重端材	名詞
きさきくものじょうはざい	妃蜘蛛の上端材	名詞
きさきくものつやきぬいと	妃蜘蛛の艶絹糸	名詞
きさきくものとうふく	妃蜘蛛の灯腹	名詞
きさきくものらんとうふく	妃蜘蛛の爛灯腹	名詞
きじんだん	鬼人弾	名詞
きじんのふんじん	鬼人の粉塵	名詞
きじんやく	鬼人薬	名詞
きじんやくぐれーと	鬼人薬グレート	名詞
きずついたじゅうここつ	傷ついた重古骨	名詞
きぜつのかくこうかく	奇絶の赫煌殻	名詞
きぜつのかくしゃくかく	奇絶の赫灼殻	名詞
きつねびほおずき	狐火ホオズキ	名詞
きひとだまどり	黄ヒトダマドリ	名詞
きょうげきびん	強撃ビン	名詞
きょうじんなつめ	強靭な爪	名詞
きょうそうえきす	狂走エキス	名詞
きょうそうやく	強走薬	名詞
きょうねんせきたん	強燃石炭	名詞
きょうりゅうこつ	強竜骨	名詞
きょうりょくまひぶくろ	強力麻痺袋	名詞
きょくさりゅうのこうりん	棘茶竜の厚鱗	名詞
きょくさりゅうのごうかく	棘茶竜の剛角	名詞
きょくさりゅうのじゅうかく	棘茶竜の重殻	名詞
きょくさりゅうのじんび	棘茶竜の靭尾	名詞
きょくさりゅうのてんりん	棘茶竜の天鱗	名詞
きょくさりゅうののうじゅうさん	棘茶竜の濃重酸	名詞
きょくさりゅうのひきょく	棘茶竜の秘棘	名詞
きょだいなりゅうこつ	巨大な竜骨	名詞
きらめきちけっと	煌めきチケット	名詞
きれあじ	キレアジ	名詞
きれいなしりこだま	きれいな尻子玉	名詞
きれいなはらぶくろ	きれいな腹袋	名詞
きれつだん	斬裂弾	名詞
きんいろのたね	金色の種	名詞
きんかりゅうのこうよくまく	金火竜の厚翼膜	名詞
きんかりゅうのこうりん	金火竜の厚鱗	名詞
きんかりゅうのじゅうかく	金火竜の重殻	名詞
きんかりゅうのひきょく	金火竜の秘棘	名詞
きんぐかぶと	キングカブト	名詞
きんぐとりす	キングトリス	名詞
きんしらぬいか	金シラヌイカ	名詞
きんじしのえいが	金獅子の鋭牙	名詞
きんじしのくろげ	金獅子の黒毛	名詞
きんじしのこくこうもう	金獅子の黒荒毛	名詞
きんじしのごうかく	金獅子の剛角	名詞
きんじしのごうそう	金獅子の剛爪	名詞
きんじしのしっぽ	金獅子の尻尾	名詞
きんじしのじゅうが	金獅子の重牙	名詞
きんじしのじゅうはざい	金獅子の重端材	名詞
きんじしのじょうはざい	金獅子の上端材	名詞
きんじしのせんかく	金獅子の尖角	名詞
きんじしのせんそう	金獅子の尖爪	名詞
きんじしのどはつてん	金獅子の怒髪天	名詞
きんせいおだんごけん	謹製おだんご券	名詞
きんのたまご	金のたまご	名詞
きんれいてんとう	金霊テントウ	名詞
ぎょうしゅくされたばくせんえき	凝縮された爆腺液	名詞
ぎょくずいかしたりゅうこっぺん	玉髄化した竜骨片	名詞
ぎょくずいかしたりゅうこつかい	玉髄化した竜骨塊	名詞
ぎょくずいかしたりゅうだいこつ	玉髄化した竜大骨	名詞
ぎょくずいかしたりゅうとうこつ	玉髄化した竜頭骨	名詞
ぎるどちけっと	ギルドチケット	名詞
ぎんいろのたね	銀色の種	名詞
ぎんかりゅうのこうりん	銀火竜の厚鱗	名詞
ぎんかりゅうのごうよく	銀火竜の剛翼	名詞
ぎんかりゅうのじゅうかく	銀火竜の重殻	名詞
ぎんかりゅうのじんび	銀火竜の靭尾	名詞
ぎんのたまご	銀のたまご	名詞
くぐつちぐも	クグツチグモ	名詞
くものす	クモの巣	名詞
くりゅうのじゅうはざい	狗竜の重端材	名詞
くりゅうのじょうはざい	狗竜の上端材	名詞
くりゅうのはざい	狗竜の端材	名詞
くるるこいん	クルルコイン	名詞
くろずんだじゅうしょうこつ	黒ずんだ重焼骨	名詞
ぐらしすめたる	グラシスメタル	名詞
ぐらすちけっと	グラスチケット	名詞
ぐれんせき	紅蓮石	名詞
ぐれんたぎるじゅうはざい	紅蓮滾る重端材	名詞
ぐれんにゆれるぎんかく	紅蓮にゆれる銀殻	名詞
ぐんかんがき	グンカンガキ	名詞
けいそうのいこくせいず	軽装の異国製図	名詞
けいたいしょくりょう	携帯食料	名詞
けがわのじゅうはざい	毛皮の重端材	名詞
けがわのじょうはざい	毛皮の上端材	名詞
けがわのはざい	毛皮の端材	名詞
けすとどんのけんかく	ケストドンの堅殻	名詞
けすとどんのこうかく	ケストドンの甲殻	名詞
けすとどんのじゅうかく	ケストドンの重殻	名詞
けすとどんのとうかく	ケストドンの頭殻	名詞
けつぁるこぶら	ケツァルコブラ	名詞
けむりのみ	ケムリの実	名詞
けものだま	獣玉	名詞
けるびのつの	ケルビの角	名詞
けんがいぎょく	堅鎧玉	名詞
けんりゅうこつ	堅竜骨	名詞
けんろうなきょこつ	堅牢な巨骨	名詞
けんろうなねじれたつの	堅牢なねじれた角	名詞
けんろうなほね	堅牢な骨	名詞
げきこうこいん	激昂コイン	名詞
げきとうおうのこいん	激闘王のコイン	名詞
げきりゅうおうのこいん	撃龍王のコイン	名詞
げきれつどくぶくろ	劇烈毒袋	名詞
げつじんりゅうのこうりん	月迅竜の厚鱗	名詞
げつじんりゅうのごうはんもう	月迅竜の豪斑毛	名詞
げつじんりゅうのじゅうが	月迅竜の重牙	名詞
げつじんりゅうのじゅうびきょく	月迅竜の重尾棘	名詞
げつじんりゅうのとうじんよく	月迅竜の透刃翼	名詞
げどくそう	げどく草	名詞
げどくやく	解毒薬	名詞
げんかんひやぼっくり	厳寒ヒヤボックリ	名詞
げんきだん	減気弾	名詞
げんきどりんこ	元気ドリンコ	名詞
げんきびん	減気ビン	名詞
げんしょのこうせき	原初の鉱石	名詞
げんせんきのこ	厳選キノコ	名詞
げんせんたけのこ	厳選タケノコ	名詞
げんちょうりゅうぎょく	幻鳥竜玉	名詞
こうかだん	硬化弾	名詞
こうかのふんじん	硬化の粉塵	名詞
こうかやく	硬化薬	名詞
こうかやくぐれーと	硬化薬グレート	名詞
こうきゅうなとさか	高級なトサカ	名詞
こうぎょのあつがわ	咬魚の厚皮	名詞
こうぎょのうえひげ	咬魚の上ヒゲ	名詞
こうぎょのかわ	咬魚の皮	名詞
こうぎょのじょうひ	咬魚の上皮	名詞
こうぎょのはがねひげ	咬魚の鋼ヒゲ	名詞
こうぎょのひげ	咬魚のヒゲ	名詞
こうせきのじゅうはざい	鉱石の重端材	名詞
こうせきのじょうはざい	鉱石の上端材	名詞
こうせきのはざい	鉱石の端材	名詞
こうちゅうのおおあご	甲虫の大顎	名詞
こうちゅうのはらぶくろ	甲虫の腹袋	名詞
こうていさぼてん	皇帝サボテン	名詞
こうりゅうのけんかく	鋼龍の堅殻	名詞
こうりゅうのごうかく	鋼龍の剛角	名詞
こうりゅうのごうそう	鋼龍の剛爪	名詞
こうりゅうのごうよく	鋼龍の剛翼	名詞
こうりゅうのしっぽ	鋼龍の尻尾	名詞
こうりゅうのじゅうかく	鋼龍の重殻	名詞
こうりゅうのじゅうはざい	鋼龍の重端材	名詞
こうりゅうのじょうはざい	鋼龍の上端材	名詞
こうりゅうのじんび	鋼龍の靭尾	名詞
こうりゅうのせんかく	鋼龍の尖角	名詞
こうりゅうのせんそう	鋼龍の尖爪	名詞
こうりゅうのつばさ	鋼龍の翼	名詞
こうりゅうのはかいぎょく	鋼龍の破傀玉	名詞
こうりゅうのほうぎょく	鋼龍の宝玉	名詞
こがねいろのじゅんねんでいど	黄金色の純粘泥土	名詞
こがねいろのでいど	黄金色の泥土	名詞
こがねいろのねんでいど	黄金色の粘泥土	名詞
こくしょくりゅうのあんこくよく	黒蝕竜の暗黒翼	名詞
こくしょくりゅうのきょうさんそう	黒蝕竜の剛惨爪	名詞
こくしょくりゅうのきょうしょっかく	黒蝕竜の剛触角	名詞
こくしょくりゅうのこうりん	黒蝕竜の厚鱗	名詞
こくしょくりゅうのじゅうかく	黒蝕竜の重殻	名詞
こくしょくりゅうのじゅうはざい	黒蝕竜の重端材	名詞
こくしょくりゅうのじんび	黒蝕竜の靭尾	名詞
こくしょくりゅうのてんりん	黒蝕竜の天鱗	名詞
こくよくじちけっと	黒翼耳チケット	名詞
こけむしたじゅうどこつ	苔むした重土骨	名詞
こげにく	コゲ肉	名詞
こすもろーず	コスモローズ	名詞
こたる	小タル	名詞
こたるばくだん	小タル爆弾	名詞
こだまこうもり	コダマコウモリ	名詞
こだまさぼてん	小玉サボテン	名詞
こなききじ	子泣キジ	名詞
このえぐものくろべにいと	衛蜘蛛の黒紅糸	名詞
こはくいろのえいが	琥珀色の鋭牙	名詞
こはくいろのきば	琥珀色の牙	名詞
こはくいろのじゅうが	琥珀色の重牙	名詞
こばなさくうえきばち	小花咲く植木鉢	名詞
こやしだま	こやし玉	名詞
こりゅうこつ	古龍骨	名詞
こりゅうのじょうけつ	古龍の浄血	名詞
こりゅうのだいほうぎょく	古龍の大宝玉	名詞
こりゅうのち	古龍の血	名詞
こわれたきしのよろい	壊れた騎士の鎧	名詞
こんがりさかな	こんがり魚	名詞
こんがりにく	こんがり肉	名詞
こんごうげんしゅ	金剛原珠	名詞
こんすいぶくろ	昏睡袋	名詞
こんとんのりゅうりん	渾沌の竜鱗	名詞
ごうえんぶくろ	業炎袋	名詞
ごうてんじゅうのこうりん	剛纏獣の厚鱗	名詞
ごうてんじゅうのごうへきけん	剛纏獣の剛壁拳	名詞
ごうてんじゅうのじゅうかく	剛纏獣の重殻	名詞
ごうてんじゅうのじゅうが	剛纏獣の重牙	名詞
ごうてんじゅうのじゅうしゅうび	剛纏獣の重鍬尾	名詞
ごうてんじゅうのじゅうはざい	剛纏獣の重端材	名詞
ごうりゅうのあぎと	轟竜のアギト	名詞
ごうりゅうのうろこ	轟竜の鱗	名詞
ごうりゅうのえいが	轟竜の鋭牙	名詞
ごうりゅうのきば	轟竜の牙	名詞
ごうりゅうのけんかく	轟竜の堅殻	名詞
ごうりゅうのこうかく	轟竜の甲殻	名詞
ごうりゅうのこうりん	轟竜の厚鱗	名詞
ごうりゅうのごうそう	轟竜の剛爪	名詞
ごうりゅうのしっぽ	轟竜の尻尾	名詞
ごうりゅうのじゅうかく	轟竜の重殻	名詞
ごうりゅうのじゅうが	轟竜の重牙	名詞
ごうりゅうのじゅうはざい	轟竜の重端材	名詞
ごうりゅうのじょうはざい	轟竜の上端材	名詞
ごうりゅうのじょうりん	轟竜の上鱗	名詞
ごうりゅうのじんび	轟竜の靭尾	名詞
ごうりゅうのせんそう	轟竜の尖爪	名詞
ごうりゅうのつめ	轟竜の爪	名詞
ごうりゅうのてんりん	轟竜の天鱗	名詞
ごうりゅうのとうかく	轟竜の頭殻	名詞
ごうりゅうのはざい	轟竜の端材	名詞
ごくえんせき	獄炎石	名詞
ごくえんちょう	ゴクエンチョウ	名詞
ごくえんのこうりゅうりん	獄炎の厚龍鱗	名詞
ごくえんのりゅうりん	獄炎の龍鱗	名詞
ごくえんほおずき	獄炎ホオズキ	名詞
ごくじょうくろしんじゅ	極上黒真珠	名詞
ごくじょうざざみそ	極上ザザミソ	名詞
ごくじょうぜんまい	極上ゼンマイ	名詞
ごくじょうのけがわ	極上の毛皮	名詞
ごくじょうのはらぶくろ	極上の腹袋	名詞
ごくじょうやどしんじゅ	極上ヤド真珠	名詞
ごしっくらげ	ゴシックラゲ	名詞
ごすごしっくらげ	ゴスゴシックラゲ	名詞
ごっかんひやぼっくり	極寒ヒヤボックリ	名詞
ごっどかぶと	ゴッドカブト	名詞
ごるどらいとこうせき	ゴルドライト鉱石	名詞
ごるむこいん	ゴルムコイン	名詞
ごーるでんでん	ゴールデンデン	名詞
# さ行
さいきょうねんせきたん	最強燃石炭	名詞
さしみうお	サシミウオ	名詞
さついのはどう	殺意の波動	名詞
さふぁいあん	サファイアン	名詞
さふぁいあんこうせき	サファイアン鉱石	名詞
さめはだのうろこ	鮫肌の鱗	名詞
さんだん	散弾	名詞
さんちょうのうえばうろこ	傘鳥の上羽鱗	名詞
さんちょうのうりん	傘鳥の羽鱗	名詞
さんちょうのうろこ	傘鳥の鱗	名詞
さんちょうのおおとさか	傘鳥の大トサカ	名詞
さんちょうのくちばし	傘鳥のクチバシ	名詞
さんちょうのこうし	傘鳥の紅嘴	名詞
さんちょうのこうりん	傘鳥の厚鱗	名詞
さんちょうのじゅうはざい	傘鳥の重端材	名詞
さんちょうのじょうはざい	傘鳥の上端材	名詞
さんちょうのじょうりん	傘鳥の上鱗	名詞
さんちょうのとくじょううりん	傘鳥の特上羽鱗	名詞
さんちょうのとさか	傘鳥のトサカ	名詞
さんちょうのはざい	傘鳥の端材	名詞
さんちょうのはなとさか	傘鳥の華鶏冠	名詞
さんちょうのべにくちばし	傘鳥の紅嘴	名詞
さんどろーず	サンドローズ	名詞
ざざみこいん	ザザミコイン	名詞
ざんれつのみ	ザンレツの実	名詞
しきくものげんひはら	熾妃蜘蛛の眩灯腹	名詞
しきくものごうそう	熾妃蜘蛛の剛爪	名詞
しきくものじゅうかく	熾妃蜘蛛の重殻	名詞
しきくものじゅうこうきょく	熾妃蜘蛛の重鉤棘	名詞
しきくものつやきぬいと	熾妃蜘蛛の艶絹糸	名詞
しきゅうようけいたいしょくりょう	支給用携帯食料	名詞
しきゅうようにくえさ	支給用肉エサ	名詞
しっこくのすいしょう	漆黒の水晶	名詞
しびしびかき	シビシビ柿	名詞
しびれがすがえる	シビレガスガエル	名詞
しびれなまにく	シビレ生肉	名詞
しびれわな	シビレ罠	名詞
しまもようのかわ	縞模様の皮	名詞
しまもようのとくじょうがわ	縞模様の特上皮	名詞
しもふりそう	霜ふり草	名詞
しゃくぎんりゅうのこうけつぎょく	爵銀龍の紅血玉	名詞
しゃくぎんりゅうのこうりん	爵銀龍の厚鱗	名詞
しゃくぎんりゅうのごうかく	爵銀龍の剛角	名詞
しゃくぎんりゅうのごうよく	爵銀龍の剛翼	名詞
しゃくぎんりゅうのじゅうかく	爵銀龍の重殻	名詞
しゃくぎんりゅうのじゅうが	爵銀龍の重牙	名詞
しゃくぎんりゅうのじゅうはざい	爵銀龍の重端材	名詞
しゃくぎんりゅうのみつまたお	爵銀龍の三又尾	名詞
しゃくねついちご	灼熱イチゴ	名詞
しゃっこいけんひょうかい	しゃっこい堅氷塊	名詞
しゃっこいじゅうひょうかい	しゃっこい重氷塊	名詞
しゃっこいひょうかい	しゃっこい氷塊	名詞
しゅらげんしゅ	修羅原珠	名詞
しゅりょうおうのこいん	狩猟王のコイン	名詞
しゅんかんとうけつぶくろ	瞬間凍結袋	名詞
しょうきんぎょ	小金魚	名詞
しょうさんざい	消散剤	名詞
しょうしゅうだま	消臭玉	名詞
しょうじんのごうせいちゅう	消尽の噛生虫	名詞
しょうぞくちけっと	装束チケット	名詞
しょうぞくちけっとじー	装束チケットG	名詞
しょうねついちご	焦熱イチゴ	名詞
しらぬいか	シラヌイカ	名詞
しろたえのかつえき	白妙の滑液	名詞
しんがいぎょく	真鎧玉	名詞
しんくものいと	臣蜘蛛の糸	名詞
しんくものきぬいと	臣蜘蛛の絹糸	名詞
しんくものつやいと	臣蜘蛛の艶糸	名詞
しんぐれんいし	真紅蓮石	名詞
しんじゅいろのじゅうはざい	真珠色の重端材	名詞
しんじゅいろのじゅうひ	真珠色の柔皮	名詞
しんじゅいろのじょうはざい	真珠色の上端材	名詞
しんじゅいろのつやかわ	真珠色の艶皮	名詞
じゃぎぃのあつがわ	ジャギィの厚皮	名詞
じゃぎぃのうろこ	ジャギィの鱗	名詞
じゃぎぃのかわ	ジャギィの皮	名詞
じゃぎぃのこうりん	ジャギィの厚鱗	名詞
じゃぎぃのじょうひ	ジャギィの上皮	名詞
じゃぎぃのじょうりん	ジャギィの上鱗	名詞
じゃぐらすのうろこ	ジャグラスの鱗	名詞
じゃぐらすのかわ	ジャグラスの皮	名詞
じゃぐらすのこうりん	ジャグラスの厚鱗	名詞
じゃぐらすのじょうひ	ジャグラスの上皮	名詞
じゃぐらすのじょうりん	ジャグラスの上鱗	名詞
じゅうがいだま	重鎧玉	名詞
じゅうこうなきば	重厚な牙	名詞
じゅうこうなほね	重厚な骨	名詞
じゅうこうなりゅうこつ	重厚な竜骨	名詞
じゅうなんなあつがわ	柔軟な厚皮	名詞
じゅうりゅうこつ	重竜骨	名詞
じゅうりゅうとうかく	重竜頭殻	名詞
じゅくせいきのこ	熟成キノコ	名詞
じょうがいぎょく	上鎧玉	名詞
じょうしつなけがわ	上質な毛皮	名詞
じょうしつなけんこつ	上質な堅骨	名詞
じょうしつなねじれたつの	上質なねじれた角	名詞
じょうしつなはらぶくろ	上質な腹袋	名詞
じょうしつなひれ	上質なヒレ	名詞
じょうのかかったたからばこ	錠の掛かった宝箱	名詞
じょうりゅうこつ	上竜骨	名詞
じょおうのふぇろもん	女王のフェロモン	名詞
じんりゅうのうろこ	迅竜の鱗	名詞
じんりゅうのえいが	迅竜の鋭牙	名詞
じんりゅうのえいじんよく	迅竜の鋭刃翼	名詞
じんりゅうのえんずい	迅竜の延髄	名詞
じんりゅうのきば	迅竜の牙	名詞
じんりゅうのきょうじんよく	迅竜の剛刃翼	名詞
じんりゅうのくろげ	迅竜の黒毛	名詞
じんりゅうのこうりん	迅竜の厚鱗	名詞
じんりゅうのこつずい	迅竜の骨髄	名詞
じんりゅうのごうこくもう	迅竜の豪黒毛	名詞
じんりゅうのしっぽ	迅竜の尻尾	名詞
じんりゅうのじゅうが	迅竜の重牙	名詞
じんりゅうのじゅうきょく	迅竜の重尾棘	名詞
じんりゅうのじゅうはざい	迅竜の重端材	名詞
じんりゅうのじょうこくもう	迅竜の上黒毛	名詞
じんりゅうのじょうはざい	迅竜の上端材	名詞
じんりゅうのじょうりん	迅竜の上鱗	名詞
じんりゅうのじんび	迅竜の靭尾	名詞
じんりゅうのてんりん	迅竜の天鱗	名詞
じんりゅうのはざい	迅竜の端材	名詞
じんりゅうのはよく	迅竜の刃翼	名詞
じんりゅうのびきょく	迅竜の尾棘	名詞
じんれんたん	迅錬丹	名詞
すいこうげんしゅ	水光原珠	名詞
すいじゅうのうろこ	水獣の鱗	名詞
すいじゅうのえいそう	水獣の鋭爪	名詞
すいじゅうのこうりん	水獣の厚鱗	名詞
すいじゅうのごうそう	水獣の剛爪	名詞
すいじゅうのしっぽ	水獣の尻尾	名詞
すいじゅうのじゅうはざい	水獣の重端材	名詞
すいじゅうのじょうはざい	水獣の上端材	名詞
すいじゅうのじょうりん	水獣の上鱗	名詞
すいじゅうのじんび	水獣の靭尾	名詞
すいじゅうのつめ	水獣の爪	名詞
すいじゅうのとさか	水獣のトサカ	名詞
すいじゅうのはざい	水獣の端材	名詞
すいせいけもののあつがわ	水生獣の厚皮	名詞
すいせいけもののかわ	水生獣の皮	名詞
すいせいけもののじょうひ	水生獣の上皮	名詞
すいひゆ	垂皮油	名詞
すいひりゅうのかわ	垂皮竜の皮	名詞
すいひりゅうのじょうはざい	垂皮竜の上端材	名詞
すいひりゅうのじょうひ	垂皮竜の上皮	名詞
すいひりゅうのはざい	垂皮竜の端材	名詞
すいみんだん	睡眠弾	名詞
すいみんびん	睡眠ビン	名詞
すいみんぶくろ	睡眠袋	名詞
すいれいたるばくだん	水冷タル爆弾	名詞
すいれいだん	水冷弾	名詞
すちーむちけっと	スチームチケット	名詞
せいきこはく	精気琥珀	名詞
せいきこはくかみ	精気琥珀・上	名詞
せいきこはくせん	精気琥珀・尖	名詞
せいきはむごうなまむし	精気食む噛生虫	名詞
せいめいのだいふんじん	生命の大粉塵	名詞
せいめいのふんじん	生命の粉塵	名詞
せいゆうじゅうのけ	青熊獣の毛	名詞
せいゆうじゅうのけんかく	青熊獣の堅殻	名詞
せいゆうじゅうのけんわんこう	青熊獣の堅腕甲	名詞
せいゆうじゅうのこうかく	青熊獣の甲殻	名詞
せいゆうじゅうのごうごうもう	青熊獣の豪剛毛	名詞
せいゆうじゅうのごうもう	青熊獣の剛毛	名詞
せいゆうじゅうのじゅうかく	青熊獣の重殻	名詞
せいゆうじゅうのじゅうはざい	青熊獣の重端材	名詞
せいゆうじゅうのじゅうわんこう	青熊獣の重腕甲	名詞
せいゆうじゅうのじょうはざい	青熊獣の上端材	名詞
せいゆうじゅうのはざい	青熊獣の端材	名詞
せいゆうじゅうのわんこう	青熊獣の腕甲	名詞
せきえんのかりん	積怨の禍鱗	名詞
せきこうじゅうのけんかく	赤甲獣の堅殻	名詞
せきこうじゅうのこうかく	赤甲獣の甲殻	名詞
せきこうじゅうのごうそう	赤甲獣の剛爪	名詞
せきこうじゅうのじゃばらこう	赤甲獣の蛇腹甲	名詞
せきこうじゅうのじゅうかく	赤甲獣の重殻	名詞
せきこうじゅうのじゅうはざい	赤甲獣の重端材	名詞
せきこうじゅうのじょうはざい	赤甲獣の上端材	名詞
せきこうじゅうのせんそう	赤甲獣の尖爪	名詞
せきこうじゅうのだいじゃふくこう	赤甲獣の大蛇腹甲	名詞
せきこうじゅうのつめ	赤甲獣の爪	名詞
せきこうじゅうのはざい	赤甲獣の端材	名詞
せっきじゅうのかわ	雪鬼獣の皮	名詞
せっきじゅうのきょうけんそう	雪鬼獣の剛拳爪	名詞
せっきじゅうのけ	雪鬼獣の毛	名詞
せっきじゅうのけんそう	雪鬼獣の拳爪	名詞
せっきじゅうのけんわんこう	雪鬼獣の堅腕甲	名詞
せっきじゅうのごうかく	雪鬼獣の剛角	名詞
せっきじゅうのごうもう	雪鬼獣の剛毛	名詞
せっきじゅうのじゅうはざい	雪鬼獣の重端材	名詞
せっきじゅうのじゅうわんこう	雪鬼獣の重腕甲	名詞
せっきじゅうのじょうはざい	雪鬼獣の上端材	名詞
せっきじゅうのじょうひ	雪鬼獣の上皮	名詞
せっきじゅうのせんかく	雪鬼獣の尖角	名詞
せっきじゅうのせんけんそう	雪鬼獣の尖拳爪	名詞
せっきじゅうのつの	雪鬼獣の角	名詞
せっきじゅうのとうごうもう	雪鬼獣の凍剛毛	名詞
せっきじゅうのとくじょうひ	雪鬼獣の特上皮	名詞
せっきじゅうのはざい	雪鬼獣の端材	名詞
せっきじゅうのわんこう	雪鬼獣の腕甲	名詞
せっきたん	雪鬼胆	名詞
せつげきびん	接撃ビン	名詞
せんがいぎょく	尖鎧玉	名詞
せんこうだま	閃光玉	名詞
せんこうはむし	閃光羽虫	名詞
せんこりゅうのこうりん	焔狐竜の厚鱗	名詞
せんこりゅうのごうそう	焔狐竜の剛爪	名詞
せんこりゅうのしろごうもう	焔狐竜の白剛毛	名詞
せんこりゅうのしろじんび	焔狐竜の白靭尾	名詞
せんこりゅうのてんりん	焔狐竜の天鱗	名詞
せんこりゅうのとくにしきひれ	焔狐竜の特錦ヒレ	名詞
せんすいちけっと	潜水チケット	名詞
せんていがき	センテイガキ	名詞
せんとりあこうせき	セントリア鉱石	名詞
せんはりゅうのきょうぎょく	千刃竜の鏡玉	名詞
せんはりゅうのざんじんりん	千刃竜の斬刃鱗	名詞
せんはりゅうのざんよくそう	千刃竜の斬翼爪	名詞
せんはりゅうのじゅうはざい	千刃竜の重端材	名詞
せんはりゅうのせんれつそう	千刃竜の閃裂爪	名詞
せんはりゅうのぜつそうび	千刃竜の絶槍尾	名詞
せんはりゅうのだんとうかく	千刃竜の断刀角	名詞
せんはりゅうのはじん	千刃竜の破刃	名詞
せんりゅうこつ	尖竜骨	名詞
ぜっぴんきのこ	絶品キノコ	名詞
ぜっぴんたけのこ	絶品タケノコ	名詞
そうこくのへんいかく	相克の変異角	名詞
そうしょくしゅのだいじゅうこつ	草食種の大重骨	名詞
そうしょくりゅうのけんかく	草食竜の堅殻	名詞
そうしょくりゅうのこうかく	草食竜の甲殻	名詞
そうしょくりゅうのごくじょうなたまご	草食竜の極上な卵	名詞
そうしょくりゅうのじゅうはざい	草食竜の重端材	名詞
そうしょくりゅうのじょうしつなたまご	草食竜の上質な卵	名詞
そうしょくりゅうのじょうはざい	草食竜の上端材	名詞
そうしょくりゅうのたまご	草食竜の卵	名詞
そうしょくりゅうのとうかく	草食竜の頭殻	名詞
そうしょくりゅうのはざい	草食竜の端材	名詞
そうせいのあかし	蒼世の証	名詞
そうせいのほうぎょく	蒼世の宝玉	名詞
そうちょうのあつがわ	掻鳥の厚皮	名詞
そうちょうのうろこ	掻鳥の鱗	名詞
そうちょうのおおかざりばね	掻鳥の大飾り羽	名詞
そうちょうのおおくちばし	掻鳥の大クチバシ	名詞
そうちょうのかざりばね	掻鳥の飾り羽	名詞
そうちょうのかわ	掻鳥の皮	名詞
そうちょうのくちばし	掻鳥のクチバシ	名詞
そうちょうのこうりん	掻鳥の厚鱗	名詞
そうちょうのじゅうはざい	掻鳥の重端材	名詞
そうちょうのじょうはざい	掻鳥の上端材	名詞
そうちょうのじょうひ	掻鳥の上皮	名詞
そうちょうのじょうりん	掻鳥の上鱗	名詞
そうちょうのとくだいかざりばね	掻鳥の特大飾り羽	名詞
そうちょうのはざい	掻鳥の端材	名詞
そっとうこんすいぶくろ	卒倒昏睡袋	名詞
そぼくなさいすいしょう	素朴な彩水晶	名詞
そぼくなじゅうはざい	素朴な重端材	名詞
そぼくなじょうはざい	素朴な上端材	名詞
そぼくなはざい	素朴な端材	名詞
ぞうきょうざい	増強剤	名詞
# た行
たいこのはへん	太古の破片	名詞
たいこりゅうこつ	太古龍骨	名詞
たいしょくつぼかずら	大食ツボカズラ	名詞
たてかにのきょくしょうかく	盾蟹の極小殻	名詞
たてかにのごうそう	盾蟹の剛爪	名詞
たてかにのじゅうかく	盾蟹の重殻	名詞
たてかにのじゅうはざい	盾蟹の重端材	名詞
たましいゆらめくしりこだま	魂揺らめく尻子玉	名詞
たるのふた	タルの蓋	名詞
だいおうにしきうお	大王錦魚	名詞
だいかけりむし	大翔蟲	名詞
だいぐんかんがき	ダイグンカンガキ	名詞
だいけものだま	大獣玉	名詞
だいしょうのいこくせいず	代償の異国製図	名詞
だいだいひとだまどり	橙ヒトダマドリ	名詞
だいちのけっしょう	大地の結晶	名詞
だいひょうけつかせき	大氷結化石	名詞
だいりゅうぎょく	大竜玉	名詞
ちからのごふ	力の護符	名詞
ちからのつめ	力の爪	名詞
ちしきのけっしょう	知識の結晶	名詞
ちゃっかつお	チャッカツオ	名詞
ちゃっかのみ	チャッカの実	名詞
ちょうこうあつでんこう	超高圧電甲	名詞
ちょうちんおばけむし	提灯オバケムシ	名詞
ちょうでんらいこうむし	超電雷光虫	名詞
ちょうりゅうぎょく	鳥竜玉	名詞
つうじょうだん	通常弾	名詞
つたのは	ツタの葉	名詞
つちかおるじゅうどろほね	土香る重泥骨	名詞
つらぬきのみ	ツラヌキの実	名詞
てっこうせき	鉄鉱石	名詞
てっこうりゅうだん	徹甲榴弾	名詞
てんかいりゅうのこうこうよく	天廻龍の光虹翼	名詞
てんかいりゅうのこうりん	天廻龍の厚鱗	名詞
てんかいりゅうのごうかく	天廻龍の剛角	名詞
てんかいりゅうのごうじょうそう	天廻龍の剛浄爪	名詞
てんかいりゅうのじゅうかく	天廻龍の重殻	名詞
てんかいりゅうのじゅうはざい	天廻龍の重端材	名詞
てんかいりゅうのじんび	天廻龍の靭尾	名詞
てんかいりゅうのてんりん	天廻龍の天鱗	名詞
てんかいりゅうのはかいぎょく	天廻龍の破傀玉	名詞
てんくうのりゅうじんだま	天空の龍神玉	名詞
てんぐじゅうのけ	天狗獣の毛	名詞
てんぐじゅうのけんおこう	天狗獣の堅尾甲	名詞
てんぐじゅうのけんときん	天狗獣の堅頭襟	名詞
てんぐじゅうのごうごうもう	天狗獣の豪剛毛	名詞
てんぐじゅうのごうそう	天狗獣の剛爪	名詞
てんぐじゅうのごうもう	天狗獣の剛毛	名詞
てんぐじゅうのごうわんう	天狗獣の豪腕羽	名詞
てんぐじゅうのじゅうときん	天狗獣の重頭襟	名詞
てんぐじゅうのじゅうはざい	天狗獣の重端材	名詞
てんぐじゅうのじゅうびこう	天狗獣の重尾甲	名詞
てんぐじゅうのじょうはざい	天狗獣の上端材	名詞
てんぐじゅうのじょうわんう	天狗獣の上腕羽	名詞
てんぐじゅうのせんそう	天狗獣の尖爪	名詞
てんぐじゅうのつめ	天狗獣の爪	名詞
てんぐじゅうのときん	天狗獣の頭襟	名詞
てんぐじゅうのはざい	天狗獣の端材	名詞
てんぐじゅうのびこう	天狗獣の尾甲	名詞
てんぐじゅうのわんう	天狗獣の腕羽	名詞
てんごこいん	テンゴコイン	名詞
てんすいりゅうきょくのはかいぎょく	天彗龍極の破傀玉	名詞
てんすいりゅうのかくじゅうはざい	天彗龍の赫重端材	名詞
てんすいりゅうのかくじょうはざい	天彗龍の赫上端材	名詞
てんすいりゅうのごうそう	天彗龍の剛爪	名詞
てんすいりゅうのしっぽ	天彗龍の尻尾	名詞
てんすいりゅうのせんそう	天彗龍の尖爪	名詞
てんすいりゅうのせんび	天彗龍の旋尾	名詞
てんすいりゅうのだいはいせんこう	天彗龍の大背尖甲	名詞
てんすいりゅうのはいせんこう	天彗龍の背尖甲	名詞
てんどうえまきもの	天道絵巻物	名詞
てんをこがすぎんよく	天を焦がす銀翼	名詞
でいおうりゅうのうろこ	泥翁竜の鱗	名詞
でいおうりゅうのおうぎょく	泥翁竜の黄玉	名詞
でいおうりゅうのけひれ	泥翁竜の毛ヒレ	名詞
でいおうりゅうのけんかく	泥翁竜の堅殻	名詞
でいおうりゅうのげきりん	泥翁竜の逆鱗	名詞
でいおうりゅうのこうかく	泥翁竜の甲殻	名詞
でいおうりゅうのこうりん	泥翁竜の厚鱗	名詞
でいおうりゅうのごうそう	泥翁竜の剛爪	名詞
でいおうりゅうのごうもうひれ	泥翁竜の剛毛ヒレ	名詞
でいおうりゅうのごうもうひれ	泥翁竜の豪毛ヒレ	名詞
でいおうりゅうのしっぽ	泥翁竜の尻尾	名詞
でいおうりゅうのじゅうかく	泥翁竜の重殻	名詞
でいおうりゅうのじゅうはざい	泥翁竜の重端材	名詞
でいおうりゅうのじょうはざい	泥翁竜の上端材	名詞
でいおうりゅうのじょうりん	泥翁竜の上鱗	名詞
でいおうりゅうのせんそう	泥翁竜の尖爪	名詞
でいおうりゅうのせんにんひげ	泥翁竜の仙人髭	名詞
でいおうりゅうのちょうぜん	泥翁竜の長髭	名詞
でいおうりゅうのつめ	泥翁竜の爪	名詞
でいおうりゅうのてんりん	泥翁竜の天鱗	名詞
でいおうりゅうのはざい	泥翁竜の端材	名詞
でいおうりゅうのひげ	泥翁竜の髭	名詞
でいおうりゅうのべんび	泥翁竜の鞭尾	名詞
でいぎょりゅうのうえひれ	泥魚竜の上ヒレ	名詞
でいぎょりゅうのえいが	泥魚竜の鋭牙	名詞
でいぎょりゅうのけんかく	泥魚竜の堅殻	名詞
でいぎょりゅうのこうりん	泥魚竜の厚鱗	名詞
でいぎょりゅうのじゅうかく	泥魚竜の重殻	名詞
でいぎょりゅうのじゅうが	泥魚竜の重牙	名詞
でいぎょりゅうのじゅうはざい	泥魚竜の重端材	名詞
でいぎょりゅうのじょうはざい	泥魚竜の上端材	名詞
でいぎょりゅうのじょうりん	泥魚竜の上鱗	名詞
でいぎょりゅうのとくじょうひれ	泥魚竜の特上ヒレ	名詞
でかでかかき	デカデカ柿	名詞
でんきぶくろ	電気袋	名詞
でんげきたるばくだん	電撃タル爆弾	名詞
でんげきだん	電撃弾	名詞
でんげきぶくろ	電撃袋	名詞
でんりゅうのこうりん	電竜の厚鱗	名詞
でんりゅうのごうよくそう	電竜の剛翼爪	名詞
でんりゅうのじゅうかんこう	電竜の重冠甲	名詞
でんりゅうのじゅうきょくかく	電竜の重棘殻	名詞
でんりゅうのじゅうはざい	電竜の重端材	名詞
でんりゅうのちょうでんまく	電竜の超電膜	名詞
でんりゅうのてんりん	電竜の天鱗	名詞
でんりゅうのはさみじんび	電竜の鋏刃尾	名詞
とうかんひやぼっくり	凍寒ヒヤボックリ	名詞
とうきゅうこいん	討究コイン	名詞
とうぎおうのこいん	闘技王のコイン	名詞
とうけつぶくろ	凍結袋	名詞
とがったきば	とがった牙	名詞
とがったそう	とがった爪	名詞
とくさんきのこ	特産キノコ	名詞
とくさんたけのこ	特産タケノコ	名詞
とくせんあるびの	特撰アルビノ	名詞
とくせんきのこ	特選キノコ	名詞
とくだいひょうけつかせき	特大氷結化石	名詞
とくだいみずぶくろ	特大水袋	名詞
とくのうたいひえき	特濃体肥液	名詞
とくのうまかあぶら	特濃マカ油	名詞
とらっぷつーる	トラップツール	名詞
とれびすます	トレビスマス	名詞
とれびすますけっしょう	トレビスマス結晶	名詞
どきどきのこ	ドキドキノコ	名詞
どくがすがえる	ドクガスガエル	名詞
どくくもり	毒クモリ	名詞
どくくりゅうのあつがわ	毒狗竜の厚皮	名詞
どくくりゅうのかわ	毒狗竜の皮	名詞
どくくりゅうのけんわんこう	毒狗竜の堅腕甲	名詞
どくくりゅうのじゅうはざい	毒狗竜の重端材	名詞
どくくりゅうのじょうはざい	毒狗竜の上端材	名詞
どくくりゅうのじょうひ	毒狗竜の上皮	名詞
どくくりゅうのはざい	毒狗竜の端材	名詞
どくくりゅうのわんこう	毒狗竜の腕甲	名詞
どくけむりだま	毒けむり玉	名詞
どくだん	毒弾	名詞
どくてんぐだけ	毒テングダケ	名詞
どくどくかき	ドクドク柿	名詞
どくなげくない	毒投げクナイ	名詞
どくなまにく	毒生肉	名詞
どくびん	毒ビン	名詞
どくぶくろ	毒袋	名詞
どくようちょうのうろこ	毒妖鳥の鱗	名詞
どくようちょうのけんかく	毒妖鳥の堅殻	名詞
どくようちょうのこうかく	毒妖鳥の甲殻	名詞
どくようちょうのこうりん	毒妖鳥の厚鱗	名詞
どくようちょうのごうよく	毒妖鳥の剛翼	名詞
どくようちょうのしっぽ	毒妖鳥の尻尾	名詞
どくようちょうのじゅうかく	毒妖鳥の重殻	名詞
どくようちょうのじゅうはざい	毒妖鳥の重端材	名詞
どくようちょうのじょうはざい	毒妖鳥の上端材	名詞
どくようちょうのじょうりん	毒妖鳥の上鱗	名詞
どくようちょうのじんび	毒妖鳥の靭尾	名詞
どくようちょうのだいのどぶくろ	毒妖鳥の大喉袋	名詞
どくようちょうのつばさ	毒妖鳥の翼	名詞
どくようちょうのとくだいのどぶくろ	毒妖鳥の特大喉袋	名詞
どくようちょうののどぶくろ	毒妖鳥の喉袋	名詞
どくようちょうのはざい	毒妖鳥の端材	名詞
どくようちょうのはね	毒妖鳥の羽根	名詞
どしゃりゅうのえいそう	土砂竜の鋭爪	名詞
どしゃりゅうのけんかく	土砂竜の堅殻	名詞
どしゃりゅうのけんこう	土砂竜の堅甲	名詞
どしゃりゅうのこうかく	土砂竜の甲殻	名詞
どしゃりゅうのごうそう	土砂竜の剛爪	名詞
どしゃりゅうのしっぽ	土砂竜の尻尾	名詞
どしゃりゅうのじゅうかく	土砂竜の重殻	名詞
どしゃりゅうのじゅうこう	土砂竜の重甲	名詞
どしゃりゅうのじゅうとうかく	土砂竜の重頭殻	名詞
どしゃりゅうのじゅうはざい	土砂竜の重端材	名詞
どしゃりゅうのじょうはざい	土砂竜の上端材	名詞
どしゃりゅうのじんび	土砂竜の靭尾	名詞
どしゃりゅうのつめ	土砂竜の爪	名詞
どしゃりゅうのとうかく	土砂竜の頭殻	名詞
どしゃりゅうのはいこう	土砂竜の背甲	名詞
どしゃりゅうのはざい	土砂竜の端材	名詞
どすおおぐいまぐろ	ドス大食いマグロ	名詞
どすきれあじ	ドスキレアジ	名詞
どすくわあげは	ドスクワアゲハ	名詞
どすちゃっかつお	ドスチャッカツオ	名詞
どすはっかじき	ドスハッカジキ	名詞
どすびすかす	ドスビスカス	名詞
どすびすます	ドスビスマス	名詞
どすびすますけっしょう	ドスビスマス結晶	名詞
どらぐらいと	ドラグライト	名詞
どらぐらいとこうせき	ドラグライト鉱石	名詞
どろだまころがし	泥玉コロガシ	名詞
どんどるまりん	ドンドルマリン	名詞
# な行
なきぶくろ	鳴き袋	名詞
なまにく	生肉	名詞
なまやけにく	生焼け肉	名詞
ならくのりゅうじんだま	奈落の龍神玉	名詞
ならくのりゅうりん	奈落の龍鱗	名詞
なるがこいん	ナルガコイン	名詞
なるほどんぐり	ナルホドングリ	名詞
にえたぎるかくようえき	煮えたぎる赫耀液	名詞
にがむし	にが虫	名詞
にくあつなかわ	肉厚な皮	名詞
にくあつなじょうひ	肉厚な上皮	名詞
にくきゅうのすたんぷ	肉球のスタンプ	名詞
にくきゅうのゆうたいけん	肉球の優待券	名詞
にしきうお	錦魚	名詞
にじいろのじおーど	虹色のジオード	名詞
にじざかりきのこ	虹盛り茸	名詞
にじひとだまどり	虹ヒトダマドリ	名詞
にとろだけ	ニトロダケ	名詞
にりつをまとうらんよく	二律を纏う乱翼	名詞
にんぎょりゅうのあらかみひれ	人魚竜の荒髪ヒレ	名詞
にんぎょりゅうのうろこ	人魚竜の鱗	名詞
にんぎょりゅうのかぎづめ	人魚竜の鉤爪	名詞
にんぎょりゅうのかみひれ	人魚竜の髪ヒレ	名詞
にんぎょりゅうのけんかく	人魚竜の堅殻	名詞
にんぎょりゅうのこうかく	人魚竜の甲殻	名詞
にんぎょりゅうのこうりん	人魚竜の厚鱗	名詞
にんぎょりゅうのごうこうそう	人魚竜の剛鉤爪	名詞
にんぎょりゅうのじゅうかく	人魚竜の重殻	名詞
にんぎょりゅうのじゅうはざい	人魚竜の重端材	名詞
にんぎょりゅうのじょうはざい	人魚竜の上端材	名詞
にんぎょりゅうのじょうりん	人魚竜の上鱗	名詞
にんぎょりゅうのせんこうそう	人魚竜の尖鉤爪	名詞
にんぎょりゅうのどはつひれ	人魚竜の怒髪ヒレ	名詞
にんぎょりゅうのねむりこな	人魚竜の眠り粉	名詞
にんぎょりゅうのはざい	人魚竜の端材	名詞
にんぎょりゅうのまどろみこな	人魚竜の微睡み粉	名詞
にんぎょりゅうのゆめみこな	人魚竜のゆめみ粉	名詞
にんたいのたね	忍耐の種	名詞
ぬしのあわだつかつえき	ヌシの泡立つ滑液	名詞
ぬしのしどくきょく	ヌシの屍毒棘	名詞
ぬしのちょうでんかく	ヌシの超電殻	名詞
ぬしのとどろきほのおぶくろ	ヌシの轟炎袋	名詞
ぬしのねじれたつの	ヌシのねじれた角	名詞
ぬしのゆうしょう	ヌシの熊掌	名詞
ぬりかめ	ヌリカメ	名詞
ねおごっどかぶと	ネオゴッドカブト	名詞
ねこけのこうぎょく	ネコ毛の紅玉	名詞
ねこけのだいこうぎょく	ネコ毛の大紅玉	名詞
ねじれたかいこつ	ねじれた怪骨	名詞
ねじれたけんかいこつ	ねじれた堅怪骨	名詞
ねじれたじゅうかいこつ	ねじれた重怪骨	名詞
ねじれたつの	ねじれた角	名詞
ねったいいちご	熱帯イチゴ	名詞
ねむりがすがえる	ネムリガスガエル	名詞
ねむりそう	ネムリ草	名詞
ねむりなげくない	眠り投げクナイ	名詞
ねむりなまにく	眠り生肉	名詞
ねんせきたん	燃石炭	名詞
のうこうまかあぶら	濃厚マカ油	名詞
のうしゅくまひぶくろ	濃縮麻痺袋	名詞
のヴぁくりすたる	ノヴァクリスタル	名詞
# は行
はいいろのたね	灰色の種	名詞
はいはんするそうげきりん	背反する双逆鱗	名詞
はおうのあかし	覇王の証	名詞
はかいのけんりゅうこつ	破傀の堅龍骨	名詞
はかいのしげりゅうこつ	破傀の重龍骨	名詞
はかいのじょうりゅうけつ	破傀の浄龍血	名詞
はかいののうりゅうけつ	破傀の濃龍血	名詞
はかいのりゅうけつ	破傀の龍血	名詞
はかいのりゅうこつ	破傀の龍骨	名詞
はがねのかみりゅうりん	鋼の上龍鱗	名詞
はがねのこうりゅうりん	鋼の厚龍鱗	名詞
はがねのたまご	鋼のたまご	名詞
はくとじゅうのおおみみ	白兎獣の大耳	名詞
はくとじゅうのきょうとうそう	白兎獣の剛凍爪	名詞
はくとじゅうのけ	白兎獣の毛	名詞
はくとじゅうのけんふくこう	白兎獣の堅腹甲	名詞
はくとじゅうのごうごうもう	白兎獣の豪剛毛	名詞
はくとじゅうのごうもう	白兎獣の剛毛	名詞
はくとじゅうのじごくみみ	白兎獣の地獄耳	名詞
はくとじゅうのじゅうはざい	白兎獣の重端材	名詞
はくとじゅうのじゅうふくこう	白兎獣の重腹甲	名詞
はくとじゅうのじょうはざい	白兎獣の上端材	名詞
はくとじゅうのとうそう	白兎獣の凍爪	名詞
はくとじゅうのはざい	白兎獣の端材	名詞
はくとじゅうのひょうそう	白兎獣の氷爪	名詞
はくとじゅうのふくこう	白兎獣の腹甲	名詞
はくとじゅうのみみ	白兎獣の耳	名詞
はくひょうしょくのじおーど	薄氷色のジオード	名詞
はくめんこんもう	ハクメンコンモウ	名詞
はじけいわし	はじけイワシ	名詞
はちみつ	ハチミツ	名詞
はっかじき	ハッカジキ	名詞
はっかのみ	ハッカの実	名詞
はっきんさかな	白金魚	名詞
はなすずむし	ハナスズムシ	名詞
はりのみ	ハリの実	名詞
はるよこい	春夜鯉	名詞
はんたーりんぐ	ハンターリング	名詞
ばぎぃのうろこ	バギィの鱗	名詞
ばぎぃのかわ	バギィの皮	名詞
ばぎぃのじょうりん	バギィの上鱗	名詞
ばくえんぶくろ	爆炎袋	名詞
ばくはなげくない	爆破投げクナイ	名詞
ばくはびん	爆破ビン	名詞
ばくふのいろどりすいしょう	瀑布の彩水晶	名詞
ばくやく	爆薬	名詞
ばくりんりゅうのけんかく	爆鱗竜の堅殻	名詞
ばくりんりゅうのこうりん	爆鱗竜の厚鱗	名詞
ばくりんりゅうのごうそう	爆鱗竜の剛爪	名詞
ばくりんりゅうのごうよく	爆鱗竜の剛翼	名詞
ばくりんりゅうのしっぽ	爆鱗竜の尻尾	名詞
ばくりんりゅうのじゅう	爆鱗竜の重尾	名詞
ばくりんりゅうのじゅうかく	爆鱗竜の重殻	名詞
ばくりんりゅうのじゅうはざい	爆鱗竜の重端材	名詞
ばくりんりゅうのじょうはざい	爆鱗竜の上端材	名詞
ばくりんりゅうのじょうりん	爆鱗竜の上鱗	名詞
ばくりんりゅうのせんそう	爆鱗竜の尖爪	名詞
ばくりんりゅうのつばさ	爆鱗竜の翼	名詞
ばくりんりゅうのてんりん	爆鱗竜の天鱗	名詞
ばくりんりゅうのばくせん	爆鱗竜の爆腺	名詞
ばくりんりゅうのばくせんそく	爆鱗竜の爆腺束	名詞
ばくりんりゅうのほうぎょく	爆鱗竜の宝玉	名詞
ばくれつのみ	バクレツの実	名詞
ばぜるこいん	バゼルコイン	名詞
ばるばれくぉーつ	バルバレクォーツ	名詞
ばんがくりゅうのあつけがわ	蛮顎竜の厚毛皮	名詞
ばんがくりゅうのうろこ	蛮顎竜の鱗	名詞
ばんがくりゅうのえいが	蛮顎竜の鋭牙	名詞
ばんがくりゅうのきば	蛮顎竜の牙	名詞
ばんがくりゅうのけがわ	蛮顎竜の毛皮	名詞
ばんがくりゅうのげきりん	蛮顎竜の逆鱗	名詞
ばんがくりゅうのこうりん	蛮顎竜の厚鱗	名詞
ばんがくりゅうのしっぽ	蛮顎竜の尻尾	名詞
ばんがくりゅうのじゅうが	蛮顎竜の重牙	名詞
ばんがくりゅうのじゅうはざい	蛮顎竜の重端材	名詞
ばんがくりゅうのじゅうびこつ	蛮顎竜の重鼻骨	名詞
ばんがくりゅうのじょうけがわ	蛮顎竜の上毛皮	名詞
ばんがくりゅうのじょうはざい	蛮顎竜の上端材	名詞
ばんがくりゅうのじょうりん	蛮顎竜の上鱗	名詞
ばんがくりゅうのじんび	蛮顎竜の靭尾	名詞
ばんがくりゅうのだいびこつ	蛮顎竜の大鼻骨	名詞
ばんがくりゅうのてんりん	蛮顎竜の天鱗	名詞
ばんがくりゅうのはざい	蛮顎竜の端材	名詞
ばんがくりゅうのびこつ	蛮顎竜の鼻骨	名詞
ばんがくりゅうのほうぎょく	蛮顎竜の宝玉	名詞
ばんだなちけっと	バンダナチケット	名詞
ぱーるでんでん	パールデンデン	名詞
ひいしころがし	火石コロガシ	名詞
ひおうぎかわず	ヒオウギカワズ	名詞
ひかりむし	光蟲	名詞
ひこうちゅうのけんかく	飛甲虫の堅殻	名詞
ひこうちゅうのこうかく	飛甲虫の甲殻	名詞
ひこうちゅうのざんわ	飛甲虫の斬羽	名詞
ひこうちゅうのじゅうはざい	飛甲虫の重端材	名詞
ひこうちゅうのじょうはざい	飛甲虫の上端材	名詞
ひこうちゅうのはざい	飛甲虫の端材	名詞
ひこうちゅうのはね	飛甲虫の羽	名詞
ひこうちゅうのまひばり	飛甲虫の麻痺針	名詞
ひたまほおずき	火玉ホオズキ	名詞
ひてんぐじゅうのごうごうもう	緋天狗獣の豪剛毛	名詞
ひてんぐじゅうのごうそう	緋天狗獣の剛爪	名詞
ひてんぐじゅうのごうわんう	緋天狗獣の豪腕羽	名詞
ひてんぐじゅうのじゅうときん	緋天狗獣の重頭襟	名詞
ひてんぐじゅうのじゅうびこう	緋天狗獣の重尾甲	名詞
ひとだまどり	ヒトダマドリ	名詞
ひみつのへんそうつーる	秘密の変装ツール	名詞
ひみつのぽーち	秘密のポーチ	名詞
ひゃくめまだら	ヒャクメマダラ	名詞
ひゃくりゅうげきたい	百竜撃退	名詞
ひゃくりゅうげきたいのあかし	百竜撃退の証	名詞
ひゃくりゅうげきたいのあかしい	百竜撃退の証・五	名詞
ひゃくりゅうげきたいのあかしいち	百竜撃退の証・一	名詞
ひゃくりゅうげきたいのあかしく	百竜撃退の証・九	名詞
ひゃくりゅうげきたいのあかししち	百竜撃退の証・七	名詞
ひゃくりゅうげきたいのあかしはち	百竜撃退の証・八	名詞
ひゃくりゅうげきたいのあかしふた	百竜撃退の証・二	名詞
ひゃくりゅうげきたいのあかしみ	百竜撃退の証・三	名詞
ひゃくりゅうげきたいのあかしよん	百竜撃退の証・四	名詞
ひゃくりゅうげきたいのあかしろく	百竜撃退の証・六	名詞
ひゃっかんひやぼっくり	冷寒ヒヤボックリ	名詞
ひやく	秘薬	名詞
ひょうがりゅうのあつけがわ	氷牙竜の厚毛皮	名詞
ひょうがりゅうのえいそう	氷牙竜の鋭爪	名詞
ひょうがりゅうのけがわ	氷牙竜の毛皮	名詞
ひょうがりゅうのけんかく	氷牙竜の堅殻	名詞
ひょうがりゅうのこうかく	氷牙竜の甲殻	名詞
ひょうがりゅうのごうそう	氷牙竜の剛爪	名詞
ひょうがりゅうのしっぽ	氷牙竜の尻尾	名詞
ひょうがりゅうのじゅうかく	氷牙竜の重殻	名詞
ひょうがりゅうのじゅうきょく	氷牙竜の重棘	名詞
ひょうがりゅうのじゅうはざい	氷牙竜の重端材	名詞
ひょうがりゅうのじょうけがわ	氷牙竜の上毛皮	名詞
ひょうがりゅうのじょうはざい	氷牙竜の上端材	名詞
ひょうがりゅうのじんび	氷牙竜の靭尾	名詞
ひょうがりゅうのつめ	氷牙竜の爪	名詞
ひょうがりゅうのとげ	氷牙竜の棘	名詞
ひょうがりゅうのはざい	氷牙竜の端材	名詞
ひょうけつかせき	氷結化石	名詞
ひょうけつたるばくだん	氷結タル爆弾	名詞
ひょうけつだん	氷結弾	名詞
ひょうけつぶくろ	氷結袋	名詞
ひょうしょうのこうりゅうりん	氷晶の厚龍鱗	名詞
ひょうじんぎょりゅうのかみひれ	氷人魚竜の髪ヒレ	名詞
ひょうじんぎょりゅうのとうかく	氷人魚竜の凍殻	名詞
ひょうじんぎょりゅうのとうそう	氷人魚竜の凍爪	名詞
ひょうじんぎょりゅうのとうりん	氷人魚竜の凍鱗	名詞
ひょうばくのさいすいしょう	氷瀑の彩水晶	名詞
ひょうりゅうのかんかく	冰龍の冠角	名詞
ひょうりゅうのごうそう	冰龍の剛爪	名詞
ひょうりゅうのごうよく	冰龍の剛翼	名詞
ひょうりゅうのじゅうかく	冰龍の重殻	名詞
ひょうりゅうのじんび	冰龍の靭尾	名詞
ひょうりゅうのれいぎょく	冰龍の零玉	名詞
ひょうろうりゅうのこうりん	氷狼竜の厚鱗	名詞
ひょうろうりゅうのごうしゅそう	氷狼竜の剛朱爪	名詞
ひょうろうりゅうのじゅうかく	氷狼竜の重殻	名詞
ひょうろうりゅうのじゅうはざい	氷狼竜の重端材	名詞
ひょうろうりゅうのじんびかく	氷狼竜の靭尾殻	名詞
ひょうろうりゅうのひひょうぎょく	氷狼竜の秘氷玉	名詞
ひょうろうりゅうのひょうそうかく	氷狼竜の雹蒼核	名詞
ひよくなどろ	肥沃なドロ	名詞
ひらいりゅうのあつけがわ	飛雷竜の厚毛皮	名詞
ひらいりゅうのうろこ	飛雷竜の鱗	名詞
ひらいりゅうのけがわ	飛雷竜の毛皮	名詞
ひらいりゅうのこうひまく	飛雷竜の厚皮膜	名詞
ひらいりゅうのこうりん	飛雷竜の厚鱗	名詞
ひらいりゅうのごうそう	飛雷竜の剛爪	名詞
ひらいりゅうのじゅうはざい	飛雷竜の重端材	名詞
ひらいりゅうのじょうけがわ	飛雷竜の上毛皮	名詞
ひらいりゅうのじょうはざい	飛雷竜の上端材	名詞
ひらいりゅうのじょうりん	飛雷竜の上鱗	名詞
ひらいりゅうのせんそう	飛雷竜の尖爪	名詞
ひらいりゅうのつめ	飛雷竜の爪	名詞
ひらいりゅうのでんきょくばり	飛雷竜の電極針	名詞
ひらいりゅうのはざい	飛雷竜の端材	名詞
ひらいりゅうのひまく	飛雷竜の皮膜	名詞
ひらいりゅうのらいきょくばり	飛雷竜の雷極針	名詞
ひらいりゅうのらいこうばり	飛雷竜の雷光針	名詞
びしょくつぼかずら	美食ツボカズラ	名詞
びすます	ビスマス	名詞
びすますきせき	ビスマス輝石	名詞
びすますけっしょう	ビスマス結晶	名詞
びすますこうせき	ビスマス光石	名詞
びすますしちこうせき	ビスマス七光石	名詞
びすますせき	ビスマス石	名詞
びっぐらぶれしあ	ビッグラブレシア	名詞
ぴかぴかかき	ピカピカ柿	名詞
ぴゅあくりすたる	ピュアクリスタル	名詞
ふぁんごのあたま	ファンゴの頭	名詞
ふぁんごのあつけがわ	ファンゴの厚毛皮	名詞
ふぁんごのけがわ	ファンゴの毛皮	名詞
ふぁんごのじょうけがわ	ファンゴの上毛皮	名詞
ふうじんのりゅうぎょく	風神の龍玉	名詞
ふうじんのりゅうじんだま	風神の龍神玉	名詞
ふうじんりゅうのかぜぶくろ	風神龍の風袋	名詞
ふうじんりゅうのけんかく	風神龍の堅殻	名詞
ふうじんりゅうのごうかく	風神龍の剛角	名詞
ふうじんりゅうのごうそう	風神龍の剛爪	名詞
ふうじんりゅうのじゅうかく	風神龍の重殻	名詞
ふうじんりゅうのじゅうはざい	風神龍の重端材	名詞
ふうじんりゅうのじょうはざい	風神龍の上端材	名詞
ふうじんりゅうのじょうひ	風神龍の上皮	名詞
ふうじんりゅうのせんかく	風神龍の尖角	名詞
ふうじんりゅうのせんそう	風神龍の尖爪	名詞
ふうじんりゅうのとくじょうひ	風神龍の特上皮	名詞
ふうじんりゅうのへききょく	風神龍の碧棘	名詞
ふうじんりゅうのへきじゅうきょく	風神龍の碧重棘	名詞
ふうじんりゅうのぼうふうぶくろ	風神龍の暴風袋	名詞
ふしちゅう	不死虫	名詞
ふしちゅうのこーぱる	不死虫のコーパル	名詞
ふるびたしんくのつの	古びた真紅の角	名詞
ふるびたちょうどひん	古びた調度品	名詞
ふるめかしいしゅき	古めかしい手記	名詞
ふろぎぃのうろこ	フロギィの鱗	名詞
ふろぎぃのかわ	フロギィの皮	名詞
ふろぎぃのじょうりん	フロギィの上鱗	名詞
ふろしすめたる	フロシスメタル	名詞
ふんえんほとばしるごうわんじん	憤怨迸る業腕刃	名詞
ぶよぶよしたかわ	ブヨブヨした皮	名詞
ぶよぶよしたはざい	ブヨブヨした端材	名詞
ぷらちなのたまご	プラチナのたまご	名詞
へいたいのふぇろもん	兵隊のフェロモン	名詞
べにあきらちけっと	紅晶チケット	名詞
べにいろのたね	紅色の種	名詞
べにひとだまどり	紅ヒトダマドリ	名詞
べりおこいん	ベリオコイン	名詞
べるなすとーん	ベルナストーン	名詞
ぺぴぽぱんぷきん	ペピポパンプキン	名詞
ほうこりゅうのうろこ	泡狐竜の鱗	名詞
ほうこりゅうのげきりん	泡狐竜の逆鱗	名詞
ほうこりゅうのこうりん	泡狐竜の厚鱗	名詞
ほうこりゅうのごうそう	泡狐竜の剛爪	名詞
ほうこりゅうのしごうもう	泡狐竜の紫剛毛	名詞
ほうこりゅうのしじょうもう	泡狐竜の紫上毛	名詞
ほうこりゅうのしじんび	泡狐竜の紫靭尾	名詞
ほうこりゅうのしっぽ	泡狐竜の尻尾	名詞
ほうこりゅうのしもう	泡狐竜の紫毛	名詞
ほうこりゅうのじゅうはざい	泡狐竜の重端材	名詞
ほうこりゅうのじょうにしきひれ	泡狐竜の上錦ヒレ	名詞
ほうこりゅうのじょうはざい	泡狐竜の上端材	名詞
ほうこりゅうのじょうりん	泡狐竜の上鱗	名詞
ほうこりゅうのすいぎょく	泡狐竜の水玉	名詞
ほうこりゅうのせんそう	泡狐竜の尖爪	名詞
ほうこりゅうのつめ	泡狐竜の爪	名詞
ほうこりゅうのてんりん	泡狐竜の天鱗	名詞
ほうこりゅうのとくにしきひれ	泡狐竜の特錦ヒレ	名詞
ほうこりゅうのにしきひれ	泡狐竜の錦ヒレ	名詞
ほうこりゅうのはざい	泡狐竜の端材	名詞
ほうさんだん	放散弾	名詞
ほうせきのいこくせいず	宝石の異国製図	名詞
ほうへいひざみ	ホウヘイヒザミ	名詞
ほうよくなどろ	豊沃なドロ	名詞
ほかくようますいだま	捕獲用麻酔玉	名詞
ほかくようますいだん	捕獲用麻酔弾	名詞
ほしみのはな	星見の花	名詞
ほしみのれいか	星見の麗花	名詞
ほしもどりのきはな	星戻の稀花	名詞
ほねのじゅうはざい	骨の重端材	名詞
ほねのじょうはざい	骨の上端材	名詞
ほねのはざい	骨の端材	名詞
ほむらちょう	ホムラチョウ	名詞
ほわいとればー	ホワイトレバー	名詞
ぼむがすがえる	ボムガスガエル	名詞
ぼろすこいん	ボロスコイン	名詞
ぽぽのたん	ポポノタン	名詞
# ま行
まからいと	マカライト	名詞
まからいとこうせき	マカライト鉱石	名詞
まがまがしいぬの	禍々しい布	名詞
まがまがしいめいふ	禍々しい冥布	名詞
まがまがしいやあんふ	禍々しい闇布	名詞
まきしぱんぷきん	マキシパンプキン	名詞
まきむし	マキムシ	名詞
まくらさかがい	マクラサカガイ	名詞
またたび	マタタビ	名詞
まねききずく	マネキキズク	名詞
まひだけ	マヒダケ	名詞
まひだん	麻痺弾	名詞
まひなげくない	麻痺投げクナイ	名詞
まひびん	麻痺ビン	名詞
まひぶくろ	麻痺袋	名詞
まもりのごふ	守りの護符	名詞
まもりのつめ	守りの爪	名詞
まるとりのとくじょうはね	丸鳥の特上羽	名詞
まるとりのはね	丸鳥の羽	名詞
まんどらごら	マンドラゴラ	名詞
まんまるどんぐり	まんまるドングリ	名詞
まーれちけっと	マーレチケット	名詞
みじゅくなかいめんしつ	未熟な海綿質	名詞
みずぶくろ	水袋	名詞
みずべのいこくせいず	水辺の異国製図	名詞
みつぼしつぼかずら	三ツ星ツボカズラ	名詞
みつりんきのこ	密林キノコ	名詞
みつりんぜんまい	密林ゼンマイ	名詞
みどりしらぬいか	緑シラヌイカ	名詞
みどりひとだまどり	緑ヒトダマドリ	名詞
みながるでないと	ミナガルデナイト	名詞
みょうおうげんしゅ	明王原珠	名詞
みんくりゅうのあつがわ	眠狗竜の厚皮	名詞
みんくりゅうのかわ	眠狗竜の皮	名詞
みんくりゅうのじゅうはざい	眠狗竜の重端材	名詞
みんくりゅうのじょうはざい	眠狗竜の上端材	名詞
みんくりゅうのじょうひ	眠狗竜の上皮	名詞
みんくりゅうのせんそう	眠狗竜の尖爪	名詞
みんくりゅうのつめ	眠狗竜の爪	名詞
みんくりゅうのはざい	眠狗竜の端材	名詞
むしのじゅうはざい	虫の重端材	名詞
むしのじょうはざい	虫の上端材	名詞
むしのはざい	虫の端材	名詞
むーんどろっぷ	ムーンドロップ	名詞
めいえんりゅうのこんこうび	冥淵龍の昏鉤尾	名詞
めいえんりゅうのじゃかく	冥淵龍の邪角	名詞
めいえんりゅうのじゅうはざい	冥淵龍の重端材	名詞
めいえんりゅうのせんえんそう	冥淵龍の穿淵爪	名詞
めいえんりゅうのだよくそう	冥淵龍の堕翼爪	名詞
めいえんりゅうのはいごんかく	冥淵龍の背巌殻	名詞
めすかりょうのうえとげ	雌火竜の上棘	名詞
めすかりょうのうろこ	雌火竜の鱗	名詞
めすかりょうのけんかく	雌火竜の堅殻	名詞
めすかりょうのげきりん	雌火竜の逆鱗	名詞
めすかりょうのこうかく	雌火竜の甲殻	名詞
めすかりょうのこうぎょく	雌火竜の紅玉	名詞
めすかりょうのこうよくまく	雌火竜の厚翼膜	名詞
めすかりょうのこうりん	雌火竜の厚鱗	名詞
めすかりょうのじゅうかく	雌火竜の重殻	名詞
めすかりょうのじゅうはざい	雌火竜の重端材	名詞
めすかりょうのじょうはざい	雌火竜の上端材	名詞
めすかりょうのじょうりん	雌火竜の上鱗	名詞
めすかりょうのてんりん	雌火竜の天鱗	名詞
めすかりょうのとげ	雌火竜の棘	名詞
めすかりょうのはざい	雌火竜の端材	名詞
めすかりょうのひきょく	雌火竜の秘棘	名詞
めすかりょうのよくまく	雌火竜の翼膜	名詞
めつりゅうだん	滅龍弾	名詞
めらんじぇ	メランジェ	名詞
めらんじぇこうせき	メランジェ鉱石	名詞
もうどくぶくろ	猛毒袋	名詞
もこふわちけっと	もこふわチケット	名詞
もどりだま	モドリ玉	名詞
もんすたーのきも	モンスターのキモ	名詞
もんすたーのたいえき	モンスターの体液	名詞
もんすたーのとくのう	モンスターの特濃	名詞
もんすたーののうじゅう	モンスターの濃汁	名詞
もんすたーのふん	モンスターのフン	名詞
# や行
やくそう	薬草	名詞
やくようまかあぶら	薬用マカ油	名詞
やくよけだけ	ヤクヨケダケ	名詞
やさからす	ヤサカラス	名詞
やまぶきしらぬいか	山吹シラヌイカ	名詞
やまもりきのこ	山盛り茸	名詞
やみもりきのこ	闇盛り茸	名詞
ゆうえんほおずき	幽炎ホオズキ	名詞
ゆうきのあかし	勇気の証	名詞
ゆうきのあかしじー	勇気の証G	名詞
ゆうきゅうねんせきたん	悠久燃石炭	名詞
ゆきいしころがし	雪石コロガシ	名詞
ゆにおんこうせき	ユニオン鉱石	名詞
ようおうりゅうのきょうじんひげ	溶翁竜の剛靭髭	名詞
ようおうりゅうのこうりん	溶翁竜の厚鱗	名詞
ようおうりゅうのごうそう	溶翁竜の剛爪	名詞
ようおうりゅうのごうもうひれ	溶翁竜の豪毛ヒレ	名詞
ようおうりゅうのじゅうかく	溶翁竜の重殻	名詞
ようおうりゅうのてんりん	溶翁竜の天鱗	名詞
ようおうりゅうのべんび	溶翁竜の鞭尾	名詞
ようがんけもののうろこ	溶岩獣の鱗	名詞
ようがんけもののこうりん	溶岩獣の厚鱗	名詞
ようがんけもののじょうりん	溶岩獣の上鱗	名詞
ようきせき	妖輝石	名詞
ようはるよこい	陽春夜鯉	名詞
よくだりゅうのあたま	翼蛇竜の頭	名詞
よくだりゅうのかわ	翼蛇竜の皮	名詞
よくだりゅうのじょうひ	翼蛇竜の上皮	名詞
よくだりゅうのとくじょうあたま	翼蛇竜の特上頭	名詞
よくだりゅうのとくじょうひ	翼蛇竜の特上皮	名詞
よろいしだい	ヨロイシダイ	名詞
よろいだま	鎧玉	名詞
# ら行
らいこうちゅう	雷光虫	名詞
らいじんのりゅうぎょく	雷神の龍玉	名詞
らいじんりゅうのあつがわ	雷神龍の厚皮	名詞
らいじんりゅうのかみなりぶくろ	雷神龍の雷袋	名詞
らいじんりゅうのけんかく	雷神龍の堅殻	名詞
らいじんりゅうのごうそう	雷神龍の剛爪	名詞
らいじんりゅうのしょくしゅ	雷神龍の触手	名詞
らいじんりゅうのじゅうはざい	雷神龍の重端材	名詞
らいじんりゅうのじょうはざい	雷神龍の上端材	名詞
らいじんりゅうのじょうひ	雷神龍の上皮	名詞
らいじんりゅうのせんかく	雷神龍の尖角	名詞
らいじんりゅうのせんそう	雷神龍の尖爪	名詞
らいじんりゅうのもうしょくしゅ	雷神龍の猛触手	名詞
らいじんりゅうのらいでんぶくろ	雷神龍の雷電袋	名詞
らいでんぶくろ	雷電袋	名詞
らいとくりすたる	ライトクリスタル	名詞
らいろうりゅうのけんかく	雷狼竜の堅殻	名詞
らいろうりゅうのげきりん	雷狼竜の逆鱗	名詞
らいろうりゅうのこうかく	雷狼竜の甲殻	名詞
らいろうりゅうのこうでんかく	雷狼竜の高電殻	名詞
らいろうりゅうのこうでんもう	雷狼竜の高電毛	名詞
らいろうりゅうのごうかく	雷狼竜の剛角	名詞
らいろうりゅうのごうそう	雷狼竜の剛爪	名詞
らいろうりゅうのしっぽ	雷狼竜の尻尾	名詞
らいろうりゅうのじゅうかく	雷狼竜の重殻	名詞
らいろうりゅうのじゅうはざい	雷狼竜の重端材	名詞
らいろうりゅうのじょうはざい	雷狼竜の上端材	名詞
らいろうりゅうのじんび	雷狼竜の靭尾	名詞
らいろうりゅうのせんかく	雷狼竜の尖角	名詞
らいろうりゅうのせんそう	雷狼竜の尖爪	名詞
らいろうりゅうのたいでんもう	雷狼竜の帯電毛	名詞
らいろうりゅうのちくでんかく	雷狼竜の蓄電殻	名詞
らいろうりゅうのつの	雷狼竜の角	名詞
らいろうりゅうのつめ	雷狼竜の爪	名詞
らいろうりゅうのてんぎょく	雷狼竜の天玉	名詞
らいろうりゅうのはざい	雷狼竜の端材	名詞
らいろうりゅうのへきぎょく	雷狼竜の碧玉	名詞
らいろうりゅうのらいでんかく	雷狼竜の雷電殻	名詞
らいろうりゅうのらいでんもう	雷狼竜の雷電毛	名詞
らくようくさ	落陽草	名詞
らくようくさのはな	落陽草の花	名詞
らせつのこんごうかく	羅刹の金剛角	名詞
らぶらぶれしあ	ラブラブレシア	名詞
らぶれしあ	ラブレシア	名詞
らんきほうかい	嵐気胞塊	名詞
らんごすたのざんばね	ランゴスタの斬羽	名詞
らんごすたのじゅうかく	ランゴスタの重殻	名詞
らんぽすのあつがわ	ランポスの厚皮	名詞
らんぽすのこうりん	ランポスの厚鱗	名詞
らんまんすずむし	ランマンスズムシ	名詞
らんりゅうのこうひまく	嵐龍の厚飛膜	名詞
らんりゅうのごうかく	嵐龍の剛角	名詞
らんりゅうのごうそう	嵐龍の剛爪	名詞
らんりゅうのじゅうかく	嵐龍の重殻	名詞
らんりゅうのじゅうきょうかく	嵐龍の重胸殻	名詞
らんりゅうのせいび	嵐龍の凄尾	名詞
らーじゃんこいん	ラージャンコイン	名詞
らーじゃんはーと	ラージャンハート	名詞
りじゅうのいんかえき	狸獣の引火液	名詞
りじゅうのはっかえき	狸獣の発火液	名詞
りゅうぎょく	竜玉	名詞
りゅうげきだん	竜撃弾	名詞
りゅうげきのみ	リュウゲキの実	名詞
りゅうこつ	竜骨	名詞
りゅうごろしのみ	龍殺しの実	名詞
りゅうすいそう	流水草	名詞
りゅうのおおつぶなみだ	竜の大粒ナミダ	名詞
りゅうのごくじょうなたまご	竜の極上な卵	名詞
りゅうのさいじょうきゅうたまご	竜の最上級卵	名詞
りゅうのじょうしつなたまご	竜の上質な卵	名詞
りゅうのたまご	竜の卵	名詞
りゅうのなみだ	竜のナミダ	名詞
りゅうひほう	龍秘宝	名詞
るながろこいん	ルナガロコイン	名詞
るりげんしゅ	瑠璃原珠	名詞
れいようじゅうのあつけがわ	麗羊獣の厚毛皮	名詞
れいようじゅうのけだま	麗羊獣の毛玉	名詞
れっかいちご	烈火イチゴ	名詞
れっすいのいこくせいず	裂水の異国製図	名詞
れんごくたぎるかくようえき	煉獄滾る赫耀液	名詞
れんゆうりゅうのあつがわ	鎌鼬竜の厚皮	名詞
れんゆうりゅうのうわばお	鎌鼬竜の上刃尾	名詞
れんゆうりゅうのかわ	鎌鼬竜の皮	名詞
れんゆうりゅうのけ	鎌鼬竜の毛	名詞
れんゆうりゅうのこうけ	鎌鼬竜の厚毛	名詞
れんゆうりゅうのじゅうはざい	鎌鼬竜の重端材	名詞
れんゆうりゅうのじょうはざい	鎌鼬竜の上端材	名詞
れんゆうりゅうのじょうひ	鎌鼬竜の上皮	名詞
れんゆうりゅうのじょうもう	鎌鼬竜の上毛	名詞
れんゆうりゅうのじんび	鎌鼬竜の刃尾	名詞
れんゆうりゅうのとじんび	鎌鼬竜の砥刃尾	名詞
れんゆうりゅうのはざい	鎌鼬竜の端材	名詞
ろいやるかぶと	ロイヤルカブト	名詞
ろうこなじゅうこつ	牢固な重骨	名詞
ろくろっへび	ロクロッヘビ	名詞
ろっくらっくこう	ロックラック鉱	名詞
ろっくろーず	ロックローズ	名詞
# わ行
わいるどなくろかわ	ワイルドな黒革	名詞
わをんぱんぷきん	ワヲンパンプキン	名詞
ヴぁりあびすかす	ヴァリアビスカス	名詞

